Qxe         , Qxe         , Qxe         , Qxe         , Qxe         , Qxe         , Qxe         , Qxe         , Qxe         , Qxe         , Qxe         , Qxe         , Qxe         , Qxe         , Qxe         , Qxe         , Qxe         , Qxe         , Qxe         , Qxe         , Qxe         , Qxe         , Qxe         , Qxe         , Qxe         , Qxe         , Qxe         , Qxe         
Rd^Fmw      , Rd^Fdw      , Rd          , Rd^Es       , Rd^Es       , Rd          , Hhd^Fmw     , Hhd         , Rb^Fmw      , Sm          , Gd          , Gd          , Wwf         , Wwf         , Wwf         , Wwf         , Gd          , Re^Tf       , Rd          , Hhd         , Rd          , Rd^Es       , Rd^Fmw      , Rd^Fdw      , Rb          , Rb          , Sm          , Qxe         
Hhd         , Rd          , Rd          , Rd          , Rd          , Rd          , Rd^Fdw      , Md          , Hhd^Fdw     , Rb          , Rb          , Gd          , Wwf         , Wwf         , Wwg         , Wwf         , Gd          , Gd          , Rd          , Rd          , Rd          , Rd          , Rd^Fdw      , Hhd         , Sm          , Rb          , Rb          , Sm          
Md          , Rd          , Rd          , Rd          , Rd^Fmw      , Rd          , Rd          , Hhd         , Rd^Es       , Rb          , Rb          , Gd          , Hhd^Fdw     , Wwg         , Wwg         , Hhd^Fmw     , Gd          , Rd          , Rd^Es       , Rd          , Rd          , Rd^Es       , Hhd^Fdw     , Md          , Hhd         , Rb          , Rb          , Sm          
Rb^Fdw      , Rd^Es       , Rd^Vd       , Hhd         , Hhd^Tf      , Rd^Es       , Rd          , Rd          , Rd          , Rd          , Rd          , Gll^Tf      , Hhd         , Wwg         , Wwg         , Wwf         , Wwf         , Gd          , Gll^Fdw     , Gd^Vc       , Rd          , Rd          , Rd          , Hhd^Tf      , Rb          , Rb          , Rb          , Rb          
Rb          , Rd^Es       , Rd          , Rd          , Rd          , Cd          , Cd          , Rd          , Rd^Fdw      , Rd          , Gd          , Gd          , Gd          , Wwf         , Wwf         , Wwf         , Wwg         , Gd          , Gd          , Rd          , Rd          , Rd          , Rd          , Rb          , Rd^Es       , Rb          , Rb          , Rb          
Sm          , Rb          , Rd^Es       , Rd          , Cd          , Kd          , Rd          , Rd^Fmw      , Rd^Vda      , Rd^Es       , Rd          , Gd          , Gd          , Wwf         , Wwg         , Gll^Fmw     , Gd          , Wwg         , Gd          , Rd^Es       , Co          , Rd          , Rd^Fmw      , Rd          , Rd          , Rb^Vu       , Rd^Fdw      , Hhd^Fdw     
Sm          , Rb          , Rb          , Rd          , Rd          , Cd          , Rd          , Rd          , Rd          , Rd^Es       , Rd          , Gd          , Hhd^Fmw     , Wwg         , Wwg         , Gd          , Wwf         , Wwf         , Gd          , Hhd         , Gd          , Co          , Ko          , Rd          , Rd          , Rd          , Rd^Es       , Rd^Fdw      
Sm          , Sm          , Rb          , Hhd         , Rd          , Rd^Es       , Rd          , Rd          , Gd          , Hhd         , Gd          , Gd          , Wwf         , Wwg         , Wwf         , Wwf         , Gd          , Gd          , Rd^Es       , Gd          , Co          , Co          , Rd^Es       , Rd          , Rd          , Rd^Es       , Rb          , Rb          
Hhd         , Rb          , Sm          , Rb          , Rb          , Rd          , Rd          , Gd          , Gll^Tf      , Gd          , Wwf         , Wwf         , Gd          , Wwf         , Wwf         , Gd          , Gll^Tf      , Rd          , Rd          , Hhd^Fdw     , Rd          , Rd^Es       , Rd          , Rd          , Rd^Fmw      , Hhd^Fmw     , Rb          , Rb          
Hhd^Fmw     , Rb          , Rb          , Rb^Vht      , Rb          , Rd^Fmw      , Rd          , Rd          , Gd          , Gd          , Wwg         , Gd          , Gd          , Wwg         , Wwg         , Gd          , Gd          , Rd^Es       , Rd          , Rd          , Rd          , Rd^Fdw      , Rd          , Rd          , Rb          , Rb          , Re^Tf       , Sm          
Md          , Rd          , Rd^Es       , Rd^Es       , Rb          , Rb          , Rd          , Rd          , Rd^Es       , Gd          , Wwg         , Gll^Fdw     , Wwf         , Wwg         , Wwg         , Wwg         , Wwg         , Gll^Fmw     , Gll^Fdw     , Rd          , Rd^Es       , Rd          , Rd          , Rd          , Rb^Vo       , Sm          , Rb          , Sm          
Hd          , Rd          , Rd          , Rd          , Rd          , Md          , Hhd         , Rd          , Gd          , Gd          , Wwf         , Wwg         , Gd          , Wog         , Wog         , Gll^Fmw     , Gd          , Wwf         , Wwf         , Gd          , Gd          , Gd          , Hhd         , Rd          , Rd^Es       , Rb          , Rd          , Hhd         
Hd          , Cd          , Cd          , Rd          , Rd          , Hhd^Tf      , Gd^Vd       , Gd          , Gd          , Wwf         , Gll^Fmw     , Gd          , Gd          , Wog         , Wog         , Gd          , Gd          , Gd          , Wwf         , Gd          , Gd          , Hhd^Fmw     , Md          , Rd^Fdw      , Rd          , Rd          , Rd          , Md          
Hd          , 1 Kd        , Cd          , Rd          , Rd^Es       , Rd          , Rd^Es       , Gd          , Gd          , Wwf         , Gd          , Gd          , Md^Xm       , Md^Xm       , Md^Xm       , Hhd         , Hhd^Fdw     , Gd          , Wwf         , Gd          , Gll^Fmw     , Rd          , Rd^Es       , Rd          , Rd^Es       , Rd          , Co          , Uh          
Hd          , Cd          , Rd          , Rd          , Rd          , Rd          , Rd          , Gll^Fdw     , Gd          , Wwf         , Gd          , Hhd^Fmw     , Hhd         , Md^Xm       , Md^Xm       , Md^Xm       , Gd          , Gd          , Wwf         , Gd          , Gd          , Rd^Es       , Rd          , Rd          , Rd          , Co          , 2 Ko        , Uh          
Md          , Rd^Es       , Rd          , Rd          , Rd^Fmw      , Md          , Hhd^Fdw     , Gd          , Gd          , Wwf         , Gd          , Gd          , Gd          , Wog         , Wog         , Gd          , Gd          , Gll^Fdw     , Wwf         , Gd          , Gd          , Gd^Vc       , Hhd^Tf      , Rd          , Rd          , Co          , Co          , Uh          
Hhd         , Rd          , Rb          , Rd          , Rd          , Hhd         , Gd          , Gd          , Gd          , Wwf         , Wwf         , Gd          , Gll^Fdw     , Wog         , Wog         , Gd          , Wwg         , Wwf         , Gd          , Gd          , Rd          , Hhd         , Md          , Rd          , Rd^Es       , Rd          , Rd          , Uh          
Hhd^Tf      , Rb          , Sm          , Rb^Vda      , Rd          , Rd          , Rd          , Rd          , Rd          , Gll^Fmw     , Gll^Fdw     , Wwg         , Wwg         , Wwg         , Wwg         , Wwf         , Gll^Fmw     , Wwg         , Gd          , Rd^Es       , Rd          , Rd          , Rb          , Rb          , Rd^Es       , Rd^Es       , Rd          , Md          
Rb          , Re^Tf       , Rb          , Rb          , Rd^Es       , Rd          , Rd^Fmw      , Rd          , Rd^Es       , Rd          , Rd^Es       , Gd          , Gd          , Wwg         , Wwg         , Gd          , Gd          , Wwg         , Gd          , Gd          , Rd          , Rd          , Rd^Fdw      , Rb          , Rb^Vu       , Rb          , Rb          , Hhd         
Sm          , Rb          , Hhd^Fdw     , Rd^Fdw      , Rd          , Rd          , Rd          , Rd          , Hhd^Fmw     , Rd          , Rd          , Gll^Tf      , Gd          , Wwf         , Wwf         , Gd          , Wwf         , Wwf         , Gd          , Gll^Tf      , Gd          , Rd^Es       , Rd          , Rb          , Rb          , Sm          , Rb          , Hhd^Fdw     
Rb          , Rb          , Rd          , Rd          , Rd          , Rd          , Cd          , Cd          , Gd          , Rd^Es       , Gd          , Gd          , Wwf         , Wwf         , Wwg         , Wwf         , Gd          , Gd          , Hhd         , Gd          , Rd          , Rd^Es       , Rd          , Rd          , Hhd         , Rb          , Sm          , Sm          
Rd^Fmw      , Rd^Es       , Rd          , Rd          , Rd          , Kd          , Cd          , Gd          , Hhd         , Gd          , Wwf         , Wwf         , Gd          , Wwg         , Wwg         , Hhd^Fdw     , Gd          , Rd          , Rd          , Rd          , Rd          , Rd          , Co          , Rd          , Rd^Es       , Rb          , Rb          , Sm          
Rd^Fmw      , Rd^Fmw      , Rb^Vhcr     , Rd^Es       , Rd          , Rd^Fdw      , Rd          , Cd          , Rd          , Gd          , Wwg         , Gd          , Gll^Fdw     , Wwg         , Wwf         , Gd          , Gd          , Rd^Es       , Rd          , Rd^Vo       , Rd^Fdw      , Rd          , Ko          , Co          , Rd          , Rd^Es       , Rb          , Hhd^Fmw     
Md          , Rb          , Rb          , Rd          , Rb          , Rd          , Rd          , Rd^Es       , Rd          , Gd          , Gd          , Wwg         , Wwf         , Wwf         , Wwf         , Gd          , Gd          , Gd          , Rd          , Rd^Fmw      , Rd          , Co          , Co          , Rd          , Rd          , Rd          , Rd          , Rb          
Hhd^Fmw     , Rb          , Rb          , Rb          , Hhd^Tf      , Rd^Es       , Rd          , Rd          , Gd^Vht      , Gll^Fmw     , Gd          , Wwf         , Wwf         , Wwg         , Wwg         , Hhd         , Gll^Tf      , Rd^Es       , Rd          , Rd          , Rd^Es       , Rd          , Rd          , Hhd^Tf      , Hhd         , Rd^Vhr      , Rd          , Rd^Fmw      
Rb          , Rb          , Rb          , Hhd         , Md          , Hhd^Fmw     , Rd          , Rd          , Rd^Es       , Rd^Es       , Rd          , Gd          , Hhd^Fdw     , Wwg         , Wwg         , Hhd^Fmw     , Gd          , Rb          , Rb          , Rd          , Hhd         , Rd          , Rd          , Rd^Fdw      , Rd          , Rd^Es       , Rd          , Rd^Fdw      
Sm          , Rb          , Rb          , Sm          , Hhd         , Rd^Fmw      , Rd          , Rd          , Rd          , Rd^Es       , Gd          , Gd          , Wwf         , Wwg         , Wwf         , Wwf         , Gd          , Rb          , Rb          , Hhd^Fmw     , Md          , Rd^Fmw      , Rd          , Rd          , Rd          , Rd          , Rd          , Hhd^Fdw     
Qxe         , Sm          , Rb          , Rb          , Rd^Fmw      , Rd^Fdw      , Rd^Es       , Rd          , Hhd         , Rd          , Re^Tf       , Gd          , Wwf         , Wwf         , Wwf         , Wwf         , Gd          , Gd          , Sm          , Rb^Fdw      , Hhd         , Hhd^Fdw     , Rd          , Rd^Es       , Rd^Es       , Rd          , Rd^Fmw      , Md          
Qxe         , Qxe         , Qxe         , Qxe         , Qxe         , Qxe         , Qxe         , Qxe         , Qxe         , Qxe         , Qxe         , Qxe         , Qxe         , Qxe         , Qxe         , Qxe         , Qxe         , Qxe         , Qxe         , Qxe         , Qxe         , Qxe         , Qxe         , Qxe         , Qxe         , Qxe         , Qxe         , Qxe         
