Mm^Xm       , Mm^Xm       , Ms^Xm       , Ms^Xm       , Ms^Xm       , Gg          , Wo          , Gs          , Hh          , Ms^Xm       , Ms^Xm       , Ms^Xm       , Ms^Xm       , Ms^Xm       , Ms^Xm       , Ms^Xm       , Ms^Xm       , Mm^Xm       , Mm^Xm       , Mm^Xm       , Mm^Xm       , Mm^Xm       , Mm^Xm       , Mm^Xm       , Mm^Xm       , Ww^Xo       , Mm^Xm       , Mm^Xm       , Mm^Xm       , Mm^Xm       , Mm^Xm       , Gll^Fmf     , Gs^Xo       , Gd^Fdf      , Mm^Xm       , Gs^Xo       , Gs^Xo       , Gs^Xo       , Wo          , Wo          , Wo^Xo       , Wo^Xo       , Wo^Xo       , Wo^Xo       , Wo^Xo       
Mm^Xm       , Mm^Xm       , Mm^Xm       , Ms^Xm       , Mm^Xm       , Gg          , Wo          , Gd          , Hh          , Ms^Xm       , Ms^Xm       , Ms^Xm       , Ms^Xm       , Ms^Xm       , Ms^Xm       , Ms^Xm       , Mm^Xm       , Mm^Xm       , Hh^Uf       , Mm^Xm       , Mm^Xm       , Mm^Xm       , Mm^Xm       , Mm^Xm       , Wwf         , Wo          , Mm^Xm       , Mm^Xm       , Mm^Xm       , Mm^Xm       , Ww          , Ww          , Ww          , Mm^Xm       , Wo          , Wo          , Wo          , Wo          , Gs          , Gs          , Ww          , Wo^Xo       , Wo^Xo       , Wo^Xo       , Ds^Xo       
Gs^Fmf      , Gs^Fdf      , Gs^Fmf      , Mm^Xm       , Mm^Xm       , Gs          , Wo          , Gs          , Gs          , Mm^Xm       , Mm^Xm       , Ms^Xm       , Mm^Xm       , Mm^Xm       , Mm^Xm       , Mm^Xm       , Gs          , Hh          , Gs          , Gg          , Ss          , Mm^Xm       , Ww          , Wwf         , Gs          , Wo          , Wo          , Mm^Xm       , Wo          , Wo          , Gg          , Gs^Fdf      , Gs          , Wo          , Gs          , Gs^Uf       , Gs          , Gs          , Hh          , Wwf         , Ww          , Ww          , Mm^Xm       , Ds^Xo       , Ds^Xo       
Gs^Fdf      , Gs^Fdf      , Gs^Fmf      , Gs^Fdf      , Mm^Xm       , Hh          , Hh          , Wo          , Wo^Xo       , Gd^Xo       , Gs          , Mm^Xm       , Mm^Xm       , Mm^Xm       , Hh          , Hh          , Gs          , Gs          , Gs          , Gg          , Gs^Uf       , Ss          , Ss^Vhs      , Gs          , Gg          , Gd^Fdf      , Gs          , Wo          , Gs          , Gs          , Gs          , Gs          , Gs          , Wwf         , Gs          , Gs          , Gs          , Gs          , Wwf         , Ww^Vm       , Ss          , Ww          , Mm^Xm       , Mm^Xm       , Mm^Xm       
Gd          , Gd^Fdw      , Gs^Fdf      , Gs^Fdf      , Mm^Xm       , Mm^Xm       , Mm^Xm       , Hhd^Xo      , Hh          , Ww          , Ww          , Gs          , Gs          , Hh^Fmf      , Hh          , Gs          , Gg          , Gs          , Hh          , Gg          , Gg          , Chs         , Re          , Gll^Fp      , Gs          , Gs          , Gg          , Hhd         , Gll^Uf      , Ce          , Gg          , Gs          , Gs          , Wwf         , Re          , Gs          , Gs          , Chw         , Wwf         , Ss          , Ss          , Ss          , Mm^Xm       , Mm^Xm       , Mm^Xm       
Gd          , Gd          , Gs^Fdf      , Gs^Fdf      , Mm^Xm       , Ms^Xm       , Ms^Xm       , Mm^Xm       , Hh^Fdf      , Gs          , Wwf         , Gs          , Hh          , Gg          , Gg          , Gg          , Gg          , Gg          , Gs          , Gs          , Gg          , Wwf         , Wwf         , Gg          , Gs          , Gll         , Gg          , Gs          , Gs^Fmf      , Gg          , Gs          , Gs          , Re^Vht      , Wwf         , Gs          , Re          , Re          , Chs         , Chs         , Ss          , Chs         , Ss          , Mm^Xm       , Mm^Xm       , Mm^Xm       
Gd          , Gd          , Mm^Xm       , Mm^Xm       , Ms^Xm       , Ms^Xm       , Mm^Xm       , Mm^Xm       , Hh          , Gs          , Wwf         , Gs          , Gs          , Gg          , Gs^Fdf      , Gs          , Gs          , Gd^Fdf      , Hh          , Re          , Re          , Gs          , Re          , Wwf         , Wwf         , Hhd         , Gs          , Gg          , Gs          , Gg          , Re          , Re          , Hhd         , Ww          , Ww          , Gs          , Wwf         , 2 Khs       , Gg          , Chs         , Re          , Gg          , Hh          , Mm^Xm       , Mm^Xm       
Gd          , Gd          , Gd          , Mm^Xm       , Mm^Xm       , Mm^Xm       , Hh          , Hh          , Gs          , Gs          , Wo          , Ds          , Gs          , Gs          , Gg          , Gs          , Gg          , Re^Vdt      , Gg          , Gg          , Gs          , Re          , Hh          , Hh^Fmf      , Gg          , Wwf         , Chw         , Gs          , Re          , Re          , Gg          , Gs          , Gs          , Gs          , Ww          , Ww          , Gs          , Gg          , Gs          , Gg          , Re          , Gg          , Hh          , Mm^Xm       , Mm^Xm       
Gd          , Gd          , Gd          , Hhd         , Hhd^Xo      , Hh^Fdf      , Gs          , Gs^Fdf      , Gd          , Gd          , Gs          , Ww          , Wwf         , Gs          , Wwf         , Gg          , Gs          , Gg          , Gs          , Ds          , Gs          , Re          , Re          , Mm          , Re          , Chr         , Wwf         , Khr         , Re          , Gs          , Gs          , Gd^Fdf      , Wwf         , Ww          , Gs          , Wwf         , Gg          , Gs          , Gg^Uf       , Gg          , Re          , Gg          , Hh^Fp       , Mm^Xm       , Hh          
Wo          , Gd          , Gs          , Gd          , Gd^Xo       , Gs          , Ss          , Gs          , Gd          , Gs          , Gs^Uf       , Gs          , Gg          , Wwf         , Wwf         , Gll         , Ds          , Gg          , Gs^Fdf      , Wwf         , Wwf         , Gs          , Wwf         , Re          , Gs          , Gs          , Wwf         , Gg          , Gs          , Re          , Wwf         , Wwf         , Gs          , Gs          , Gg          , Wwf         , Wwf         , Gs          , Re          , Re          , Gg          , Gg          , Gs          , Hh          , Hh          
Gd          , Wo          , Wo          , Gd          , Gd^Xo       , Gs^Uf       , Chs         , Gs          , Gs          , Gs^Fmf      , Chr         , Chw         , Gs          , Gs          , Gs          , Ww          , Ww          , Ds          , Gs          , Gs          , Gg          , Wwf         , Gs^Fmf      , Wwf         , Re          , Re^Uf       , Wwf         , Mm          , Wwf         , Wwf         , Gg          , Re          , Gs          , Hh          , Gg          , Gs          , Wwf         , Re^Ve       , Re          , Gg          , Gs^Fds      , Gg          , Gg          , Gs          , Gg          
Gll         , Gd          , Gd          , Wo          , Wo^Xo       , Gs          , Gs          , Gs          , Gs          , Gs          , Gs          , Gd          , Chr         , Gs          , Gs^Fet      , Gs          , Wo          , Hhd^Fdf     , Gs          , Gs          , Gg          , Re          , Re          , Ss^Vhs      , Xue         , Wo          , Ww          , Wwf         , Hh          , Gs          , Gs          , Gs^Fds      , Gs          , Gs          , Gg          , Gd^Fdf      , Ss          , Hhd         , Re          , Gg          , Gg          , Gg          , Hh          , Gg          , Gg          
Gs          , Gll         , Gll         , Gd          , Gd^Xo       , Wo          , Ww          , Gs          , Gs^Fdf      , Gs          , Gs          , Gs          , Gs          , Gs          , Ds          , Ds          , Wo          , Gg          , Mm^Xm       , Gs          , Ww^Bsb\     , Ww          , Rb          , Ce          , Re          , Uue^Uf      , Wo          , Ww          , Xue         , Gs          , Gg          , Gg          , Gs          , Gs          , Gg          , Gg          , Gg          , Gg          , Re          , Gg          , Gs          , Rb          , Rb^Uf       , Mm          , Gg          
Gll^Gvs     , Gll^Gvs     , Gll^Gvs     , Gll         , Gd^Xo       , Gs          , Gs          , Wwf         , Wwf         , Gd          , Gd          , Hh          , Wwf         , Gs          , Wwf         , Ww          , Gs          , Wo^Bw/r     , Wo          , Wo          , Uh          , Rb          , Uh          , Uue         , Wwf         , Wo          , Uue         , Uue         , Xue         , Ww          , Hh          , Gs          , Wwf         , Wwf         , Wwf         , Gg          , Ds          , Gg          , Mm          , Gg          , Gg          , Rb          , Rb          , Rb          , Gg          
Gll^Gvs     , Gll^Gvs     , Gll^Gvs     , Gll^Gvs     , Gd^Xo       , Gs          , Hh          , Gs          , Ds          , Wwf         , Wwf         , Wwf         , Gs          , Wwf         , Hh          , Gs^Fmf      , Gg          , Gs          , Wwf         , Wwf         , Wwf         , Re          , Wwf         , Wwf         , Rb          , Ai          , Wwf         , Rb          , Uh          , Xue         , Xue         , Gs          , Wwf         , Rb^Uf       , Rb          , Khr         , Chr         , Gg          , Gs^Fp       , Hh^Vh       , Gg          , Gg          , Gg          , Gg          , Gg          
Gll^Gvs     , Gll^Gvs     , Gll         , Gll         , Gd^Xo       , Hh          , Hh^Fmf      , Gs          , Gs          , Gs          , Gs          , Ds          , Gs          , Gs          , Rb          , Gs          , Wwf         , Wwf         , Xue         , Wwf         , Rb          , Uue         , Wwf         , Uu^Uf       , Xu          , Ai          , Wwf         , Re          , Re          , Ww          , Xue         , Hh          , Wwf         , Gg          , Rb          , Chr         , Gs          , Gg          , Gg          , Gg          , Gg          , Gs          , Hh^Fp       , Hh          , Gg          
Gll         , Gll         , Gd          , Gll         , Gd^Xo       , Hh          , Gs          , Gs          , Gd          , Gd          , Gll^Fp      , Gs          , Chr         , Chr         , Rb          , Rb          , Wwf         , Hh          , Xue         , Ww          , Uh          , Rb          , Wwf         , Ai          , Rb          , Uu^Uf       , Wwf         , Uue         , Wwf         , Wwf         , Wwf         , Wwf         , Gg          , Gg          , Hh          , Gg          , Gg          , Ds          , Wwf         , Gg          , Ds          , Gg          , Hh          , Hh          , Gg          
Hh^Fdw      , Gd          , Hh          , Gll         , Gd^Xo       , Gs          , Gs          , Gd          , Gd          , Hh^Vct      , Mm          , Gs          , Ds          , Khr         , Wwf         , Rb^Uf       , Wwf         , Gs          , Hh          , Xue         , Xue         , Re          , Uue         , Ai          , Wwf         , Wwf         , Uh          , Re          , Uh          , Wwf         , Wo          , Gg          , Gg          , Gs^Fds      , Wwf         , Wwf         , Wwf         , Wwf         , Gg          , Wwf         , Wwf         , Gg          , Gg          , Gg          , Gg          
Hh^Fdf      , Hh          , Hh          , Gd          , Gd^Xo       , Gs          , Gd^Uf       , Gs          , Gs          , Gs          , Gll         , Gs          , Gs          , Gs          , Gs          , Wwf         , Gs          , Gs          , Gs          , Ww          , Xue         , Uue         , Wo          , Wo          , Re          , Uue         , Re          , Re          , Ww^Bsb\     , Wo          , Mm^Xm       , Wo^Bw/r     , Wo          , Ww          , Ds          , Gg          , Gg          , Hh          , Gg          , Gg          , Gs^Fds      , Wwf         , Ww          , Gs          , Gg          
Hh^Fdf      , Hh^Fdf      , Hh          , Gd          , Gd^Xo       , Mm          , Hh          , Gs          , Gs          , Gs          , Gll         , Gs          , Ss          , Gs          , Gs          , Gs          , Gg          , Gs^Fds      , Gg          , Gs          , Hhd         , Ww          , Ww          , Uue^Uf      , Xue         , Ce          , Re          , Ww          , Gd          , Gs          , Gs          , Gg          , Wo          , Ds          , Gs^Fds      , Gg          , Chr         , Gs          , Gg          , Gg          , Gg          , Gg          , Gg          , Wo          , Wo          
Wwf         , Hh          , Wwf         , Gd          , Gd^Xo       , Gs          , Gs          , Gs          , Gs^Fdf      , Gd          , Gll         , Hh          , Wwf         , Gs^Fmf      , Gs          , Gg          , Gs          , Gs^Fdf      , Gs          , Gs          , Wwf         , Wwf         , Wwf         , Wo          , Re          , Ss^Vhs      , Gs^Fdf      , Gll         , Gd          , Gs          , Gg          , Hh^Fds      , Ww          , Gg          , Gg          , Gg          , Gs          , Gg          , Chr         , Gg          , Gs          , Gg          , Chs         , Gg          , Gs          
Hh^Fdf      , Wwf         , Hh          , Wwf         , Gd^Xo       , Gs          , Gs          , Gs          , Gd          , Gd          , Gll         , Gs^Vhr      , Wwf         , Gs          , Gs          , Hh          , Gs          , Re          , Wwf         , Wwf         , Gs          , Mm          , Wwf         , Re^Uf       , Gd          , Wwf         , Wwf         , Wwf         , Wwf         , Gs          , Gs^Fds      , Ds          , Ds          , Ww          , Wwf         , Gg          , Gg          , Chw         , Gs^Uf       , Gs^Fds      , Gg          , Gg          , Ss          , Gg^Uf       , Gg          
Hh^Fdf      , Hh          , Hh^Fdf      , Wwf         , Hh^Xo       , Hh          , Hh^Fdf      , Gs          , Gll         , Gll         , Gs^Uf       , Gs          , Gs          , Wwf         , Gs          , Gs          , Wwf         , Wwf         , Gs          , Re          , Re          , Gs          , Wwf         , Gd          , Gll         , Gll         , Gll         , Gg          , Gg          , Wwf         , Gg          , Gg          , Gg          , Gg          , Wwf         , Wwf         , Wwf         , Gg          , Gg          , Gg          , Gg          , Gg          , Gs          , Gs          , Hh          
Hh          , Hh^Fdf      , Hh^Fdw      , Hh          , Mm^Xo       , Mm^Xm       , Hh          , Gs          , Gll         , Gd          , Gs          , Gs          , Gs          , Wwf         , Ww          , Ww          , Gg          , Gs^Fdf      , Gg          , Gs          , Re          , Khr         , Chw         , Chr         , Gg          , Mm          , Hh          , Gll         , Gll         , Ds          , Gs          , Gg          , Gg          , Gs          , Gg          , Gs          , Gs          , Ww          , Wo          , Gs          , Gg          , Gs^Fms      , Hh          , Hh^Fmf      , Mm^Xm       
Hh          , Hh^Fdf      , Hh          , Hh^Fdf      , Mm^Xo       , Mm^Xm       , Hh          , Gs          , Gll         , Gs          , Gs          , Gs          , Wwf         , Ww          , Ww          , Gs          , Hh          , Gg          , Re          , Re          , Gs          , Gg          , Gs          , Wwf         , Wwf         , Hh^Fp       , Gll         , Gll         , Gg          , Gll         , Hh          , Gs^Vh       , Gg          , Gg          , Gs^Fds      , Gg          , Gg          , Ds          , Wwf         , Gg          , Hh          , Hh          , Mm^Xm       , Mm^Xm       , Mm^Xm       
Gs          , Gs          , Gd          , Hh          , Hh^Xo       , Mm^Xm       , Mm^Xm       , Gs          , Chs         , Chs         , Chs         , 1 Khs       , Rd          , Gs          , Gs          , Ww          , Rd^Vht      , Rd          , Gg          , Gg          , Gs^Fp       , Gg          , Gs          , Hh          , Gg          , Wwf         , Wwf         , Gs          , Gg          , Gs          , Gg          , Gs^Fds      , Gg          , Gg          , Gg          , Gg          , Hh          , Gg          , Wwf         , Gg          , Hh^Fp       , Mm^Xm       , Mm^Xm       , Mm^Xm       , Mm^Xm       
Wo          , Ds          , Ds          , Gs          , Mm^Xo       , Mm^Xm       , Mm^Xm       , Ss          , Ss          , Ss          , Wwf         , Chs         , Gs          , Rd          , Rd          , Wwf         , Gs          , Gs          , Gs          , Gs          , Gs^Uf       , Gs          , Gs          , Gg          , Gg          , Gs          , Gll         , Wwf         , Gs          , Gg          , Hh          , Gg          , Gg          , Gs          , Hh          , Gg          , Gg          , Gs          , Ww          , Gg          , Hh          , Mm^Xm       , Mm^Xm       , Ms^Xm       , Ms^Xm       
Wo          , Wo          , Wo          , Gs          , Ds          , Mm^Xm       , Mm^Xm       , Ss          , Ss          , Ss          , Wwf         , Chw         , Gs          , Gs          , Gs          , Wwf         , Gs          , Gs          , Gs          , Chr         , Gg          , Hh          , Gg          , Gg          , Gs          , Gs^Fp       , Ss^Vhs      , Chs         , Gs^Uf       , Gs          , Gg          , Gg          , Gg          , Gs          , Hh          , Hh^Fp       , Mm^Xm       , Gg          , Gg          , Ww          , Wo^Xo       , Hhd^Xo      , Hhd         , Mm^Xm       , Mm^Xm       
Wo          , Wo          , Wo          , Wo          , Ds          , Ds          , Mm^Xm       , Ww          , Ww          , Ww^Vm       , Hh          , Gs          , Gs          , Gs          , Gs          , Ww          , Gs          , Gs          , Gs          , Gg          , Wo          , Wo          , Wo          , Gs^Fp       , Gs          , Gs          , Ww          , Ss          , Ss          , Gs          , Gg          , Gg          , Gg          , Hh          , Mm^Xm       , Mm^Xm       , Mm^Xm       , Mm^Xm       , Mm^Xm       , Gs^Xo       , Gs          , Wo          , Wo          , Mm^Xm       , Mm^Xm       
Wo          , Wo          , Ds          , Wo          , Wo          , Wo          , Wo^Xo       , Ww          , Ww          , Wwf         , Gs          , Gs          , Wo          , Gs^Uf       , Wo          , Wo          , Ww          , Gs^Fdf      , Ww          , Wo          , Mm^Xm       , Mm^Xm       , Mm^Xm       , Wo          , Wwf         , Wwf         , Mm^Xm       , Mm^Xm       , Mm^Xm       , Gs          , Hh^Uf       , Hh          , Mm^Xm       , Mm^Xm       , Mm^Xm       , Mm^Xm       , Ms^Xm       , Mm^Xm       , Mm^Xm       , Mm^Xm       , Gs          , Wo          , Wo          , Wo          , Wo          
Wo          , Wo          , Ds          , Ds          , Wo          , Wo          , Wo          , Wo^Xo       , Wo^Xo       , Gs          , Wo          , Wo          , Mm^Xm       , Wo          , Mm^Xm       , Mm^Xm       , Mm^Xm       , Ww          , Mm^Xm       , Mm^Xm       , Mm^Xm       , Mm^Xm       , Mm^Xm       , Wo          , Ms^Xm       , Mm^Xm       , Mm^Xm       , Mm^Xm       , Mm^Xm       , Mm^Xm       , Ms^Xm       , Mm^Xm       , Mm^Xm       , Mm^Xm       , Mm^Xm       , Ms^Xm       , Ms^Xm       , Ms^Xm       , Mm^Xm       , Mm^Xm       , Gs          , Wo          , Wo          , Wo          , Wo          
Wo          , Wo          , Wo          , Ds          , Ds          , Wo          , Wo          , Wo          , Wo          , Wo^Xo       , Gs^Xo       , Mm^Xm       , Gd^Fdf      , Gd^Fdf      , Gd^Fdf      , Gd^Fdf      , Gd^Fdf      , Gd^Fdw      , Mm^Xm       , Mm^Xm       , Mm^Xm       , Mm^Xm       , Mm^Xm       , Ww^Xo       , Ms^Xm       , Ms^Xm       , Ms^Xm       , Mm^Xm       , Mm^Xm       , Mm^Xm       , Mm^Xm       , Mm^Xm       , Mm^Xm       , Mm^Xm       , Mm^Xm       , Ms^Xm       , Ms^Xm       , Ms^Xm       , Ms^Xm       , Mm^Xm       , Gs          , Gs          , Gs          , Wo          , Wo          
