Qxua^Xo, Qxua^Xo, Qxua^Xo, Qxua^Xo, Qxua^Xo, Qxua^Xo, Qxua^Xo, Qxua^Xo, Qxua^Xo, Qxua^Xo, Qxua^Xo, Qxua^Xo, Qxua^Xo, Qxua^Xo, Qxua^Xo, Qxua^Xo, Qxua^Xo, Qxua^Xo, Qxua^Xo, Qxua^Xo, Qxua^Xo, Qxua^Xo, Qxua^Xo, Qxua^Xo, Qxua^Xo, Qxua^Xo, Qxua^Xo, Qxua^Xo, Qxua^Xo, Qxua^Xo, Qxua^Xo, Qxua^Xo, Qxua^Xo, Qxua^Xo, Qxua^Xo, Qxua^Xo, Qxua^Xo, Qxua^Xo, Qxua^Xo, Qxua^Xo, Qxua^Xo, Qxua^Xo, Qxua^Xo, Qxua^Xo
Qxua^Xo, Qxua^Xo, Qxua^Xo, Qxua^Xo, Qxua^Xo, Qxua^Xo, Qxua^Xo, Qxua^Xo, Qxua^Xo, Qxua^Xo, Qxua^Xo, Qxua^Xo, Qxua^Xo, Qxua^Xo, Qxua^Xo, Qxua^Xo, Qxua^Xo, Qxua^Xo, Qxua^Xo, Qxua^Xo, Qxua^Xo, Qxua^Xo, Qxua^Xo, Qxua^Xo, Qxua^Xo, Qxua^Xo, Qxua^Xo, Qxua^Xo, Qxua^Xo, Qxua^Xo, Qxua^Xo, Qxua^Xo, Qxua^Xo, Qxua^Xo, Qxua^Xo, Qxua^Xo, Qxua^Xo, Qxua^Xo, Qxua^Xo, Qxua^Xo, Qxua^Xo, Qxua^Xo, Qxua^Xo, Qxua^Xo
Qxua^Xo, Qxua^Xo, Qxua^Xo, Qxua^Xo, Qxua^Xo, Qxua^Xo, Qxua^Xo, Qxua^Xo, Qxua^Xo, Qxua^Xo, Qxua^Xo, Qxua^Xo, Qxua^Xo, Qxua^Xo, Qxua^Xo, Qxua^Xo, Qxua^Xo, Qxua^Xo, Qxua^Xo, Qxua^Xo, Qxua^Xo, Qxua^Xo, Qxua^Xo, Qxua^Xo, Qxua^Bs/, Cud, Qxua^Bs\, Qxua^Xo, Qxua^Xo, Qxua^Xo, Qxua^Xo, Qxua^Xo, Qxua^Xo, Qxua^Xo, Qxua^Xo, Qxua^Xo, Cud, Uu^Em, Rb^Tf, Uu^Em, Ql, Ql, Ql, Uu^Fp
Qxua^Xo, Qxua^Xo, Qxua^Xo, Qxua^Xo, Qxua^Xo, Qxua^Xo, Qxua^Xo, Qxua^Xo, Qxua^Xo, Qxua^Xo, Qxua^Xo, Qxua^Xo, Qxua^Xo, Qxua^Xo, Ql, Qxua^Xo, Rb^Tf, Qxua^Xo, Ql, Qxua^Xo, Uu^Fp, Qxua^Xo, Qxua^Xo, Cud, Qxua^Xo, Qxua^Xo, Qxua^Xo, Cud, Qxua^Xo, Qxua^Xo, Qxua^Xo, Qxua^Xo, Qxua^Xo, Qxua^Xo, Qxua^Xo, Qxua^Xo, Qxua^Xo, Qxua^Xo, Qxua^Xo, Ql^Bs\, Rb^Tf, Uu^Fp, Uu^Fp, Uu^Fp
Qxua^Xo, Qxua^Xo, Qxua^Xo, Qxua^Xo, Qxua^Xo, Qxua^Xo, Qxua^Xo, Qxua^Xo, Qxua^Xo, Qxua^Xo, Qxua^Xo, Qxua^Xo, Qxua^Xo, Ql, Uu, Uu^Fp, Re, Uu^Fp, Uu^Fp, Rb^Tf, Re, Rb^Tf, Uu^Fp, Qxua^Xo, Rb^Tf, Uu^Fp, Uu^Fp, Qxua^Xo, Uu, Qxua^Xo, Qxua^Xo, Qxua^Xo, Qxua^Xo, Qxua^Xo, Qxua^Xo, Qxua^Xo, Qxua^Xo, Qxua^Xo, Qxua^Xo, Ql, Qxua^Xo, Qxua^Xo, Ql, Rb^Tf
Qxua^Xo, Qxua^Xo, Qxua^Xo, Qxua^Xo, Qxua^Xo, Qxua^Xo, Qxua^Xo, Qxua^Xo, Cud, Qxua^Xo, Qxua^Xo, Qxua^Xo, Rb^Tf, Uu^Fp, Re, Re, Gs, Re, Re, Re, Ur, Re, Re, Uu, Qxua, Cud, Ql, Rb^Tf, Uu^Fp, Uu^Fp, Uu^Fp, Qxua^Xo, Qxua^Xo, Qxua^Xo, Qxua^Xo, Qxua^Xo, Qxua^Xo, Qxua^Xo, Qxua^Xo, Qxua^Xo, Qxua^Xo, Qxua^Xo, Ql, Uu^Fp
Qxua^Xo, Qxua^Xo, Qxua^Xo, Qxua^Xo, Qxua^Xo, Qxua^Xo, Cud, Qxua^Bs/, Qxua^Xo, Qxua^Xo, Ql, Qxua^Xo, Ur^Em, Re, Gs, Re, Rr^Vd, Re, Qxua, Ql, Ur, Uu^Vud, Ur, Re, Kud, Cud, 1 Kud, Ur^Em, Ql^Bs\, Ql, Ql, Uu^Fp, Uu, Qxua^Xo, Qxua^Xo, Qxua^Xo, Qxua^Xo, Qxua^Xo, Qxua^Xo, Qxua^Xo, Qxua^Xo, Qxua^Xo, Qxua^Xo, Ql
Qxua^Xo, Qxua^Xo, Qxua^Xo, Qxua^Xo, Qxua^Xo, Qxua^Xo, Qxua^Bs|, Qxua^Xo, Rb^Tf, Ql, Kud, Cud, Ur, Re, Gs^Es, Rr, Hh, Re, Re, Ur, Ql^Bs\, Qxua, Ur, Re, Rr, Cud, Re, Qxua, Re, Cud, Qxua, Rb^Tf, Uu^Fp, Ql, Qxua^Xo, Cud, Qxua^Bs\, Qxua^Xo, Qxua^Xo, Qxua^Xo, Qxua^Xo, Qxua^Xo, Qxua^Xo, Uu
Qxua^Xo, Qxua^Xo, Qxua^Xo, Qxua^Xo, Qxua^Xo, Qxua^Xo, Cud, Qxua^Xo, Rb^Tf, Ur, Qxua, Cud, Ur^Em, Re, Gs, Rr, Gs^Fp, Rb^Tf, Gg, Re, Ql, Ur, Rr, Rr, Gs^Es, Rr, Gg, Re, Gs^Em, Re, Re, Ur^Em, Ur, Uu, Rb^Tf, Qxua^Xo, Qxua^Xo, Cud, Qxua^Xo, Qxua^Xo, Qxua^Xo, Qxua^Xo, Qxua^Xo, Qxua^Xo
Qxua^Xo, Qxua^Xo, Qxua^Xo, Qxua^Xo, Qxua^Xo, Qxua^Xo, Qxua^Xo, Qxua^Xo, Ql, Ql^Bs|, Ql, Rb^Tf, Uu^Fp, Re, Gg, Rr, Rr, Gs^Em, Gg, Re, Re, Cud, Cud, Gs, Gg, Rr, Gg, Gs^Fp, Hh, Gs, Gs, Re, Uu^Vud, Qxua, Ql, Uu^Fp, Uu^Fp, Qxua^Xo, Uh, Qxua^Xo, Qxua^Xo, Qxua^Xo, Qxua^Xo, Qxua^Xo
Qxua^Xo, Qxua^Xo, Qxua^Xo, Qxua^Xo, Qxua^Xo, Qxua^Xo, Qxua^Xo, Qxua^Xo, Cud, Kud, Ur, Uh, Re, Re, Gg, Gg, Gs, Rr, Gs, Gg, Re, Gs^Fp, Kud, Gs^Em, Rr, Rr^Vd, Rr, Gg, Gs, Gs, Cud, Re, Re, Ur, Ur, Qxua, Uu, Uu, Qxua, Rb^Tf, Uh, Qxua^Xo, Qxua^Xo, Qxua^Xo
Qxua^Xo, Qxua^Xo, Qxua^Xo, Qxua^Xo, Qxua^Xo, Qxua^Xo, Qxua^Xo, Cud, Cud, Ur, Re, Re, Gg, Gg, Rr, Gs^Es, Rr, Rr, Gs^Fp, Gg, Gg, Re, Rr, Rr, Gs, Gs, Rr, Gg, Rr, Cud, Kud, Gs, Gs^Em, Re, Re, Ur, Ur, Ur, Re, Ql, Ql, Qxua^Xo, Qxua^Xo, Qxua^Xo
Qxua^Xo, Qxua^Xo, Qxua^Xo, Qxua^Xo, Qxua^Xo, Qxua^Xo, Qxua^Xo, Ql, Kud, Ur, Re, Gg^Es, Rr, Rr^Vd, Gs, Rr, Gs^Em, Rb^Tf, Hh^Em, Mm, Re, Re, Rr, Re, Re, Gg^Em, Gg, Rr, Gs^Es, Rr, Rr, Gg, Rr, Rr, Cud, Re, Re, Re, Rr^Vd, Re, Rb^Tf, Qxua^Xo, Qxua^Xo, Qxua^Xo
Qxua^Xo, Qxua^Xo, Qxua^Xo, Qxua^Xo, Cud, Qxua^Xo, Qxua^Xo, Rb^Tf, Uu^Fp, Ur, Re, Gg, Rr, Gs, Gg, Gs, Gg, Gs^Fp, Hh^Em, Re, Rb^Tf, Ur^Em, Cud, Qxu^Bs|, Qxua, Re, Re, Gg, Gs^Fp, Mm, Hh, Rr, Kud, Ur, Ql, Kud, Rr, Rr, Gg^Em, Re, Re, Qxua^Xo, Qxua^Xo, Qxua^Xo
Qxua^Xo, Qxua^Xo, Qxua^Xo, Qxua^Xo, Qxua^Bs|, Qxua^Bs\, Cud, Qxua^Xo, Re, Re, Gg, Gg, Rr, Gg^Em, Rr, Gg, Gg, Rb^Tf, Mm, Re, Qlf, Ur^Em, Cud, Kud, Re^Fp, Ql, Qxua, Re, Rr, Rr, Cud, Ql^Bs/, Cud, Cud, Ur, Re, Rr, Gs, Hh, Gg^Fp, Re, Ql, Qxua^Xo, Qxua^Xo
Qxua^Xo, Qxua^Xo, Qxua^Xo, Qxua^Xo, Cud, Qxua^Bs/, Qxua^Xo, Qxua^Xo, Re, Mm, Rr, Rr, Gs, Rr, Gg, Rr, Gg, Hh, Gg^Fp, Re, Uu, Uu, Qxua, Rb, Hhd, Hhd, Rr, Rr, Ur, Re, Re, Qxua, Kud, Ur, Re, Re, Rr, Gs^Es, Gs, Gg^Fp, Re, Ql, Qxua^Xo, Qxua^Xo
Qxua^Xo, Qxua^Xo, Qxua^Xo, Qxua^Xo, Qxua^Xo, Qxua^Xo, Re, Re, Rr, Rr, Gs^Fp, Gs^Em, Gg, Gg, Rr, Rr, Rr, Gg^Es, Rr, Rr, Xu, Xu, Uu^Fp, Cud, Cud, Rr, Hhd^Em, Qxua, Ql, Ur, Re, Ur, Ur, Ur, Rr, Rr, Hh, Rr, Cud, Gs, Re, Qxua^Xo, Qxua^Xo, Qxua^Xo
Qxua^Xo, Qxua^Xo, Qxua^Xo, Qxua^Xo, Qxua^Xo, Ql, Re, Cud, Rr, Hh, Gs, Gg, Rr, Rr, Uu^Em, Uu, Ur, Rr, Cud, Uh^Em, Rb^Tf, Rb^Fp, Uu^Em, Xu, Rb^Tf, Xu, Xu, Rb^Tf, Ql, Ur^Em, Ur^Fp, Re, Rr, Rr, Gs, Gs^Fp, Rr, Rr, Re, Re, Qxua^Xo, Qxua^Xo, Qxua^Xo, Qxua^Xo
Qxua^Xo, Qxua^Xo, Qxua^Xo, Qxua^Xo, Ql, Re, Cud, Rr, Hh, Gs^Fp, Gg^Es, Gg, Rr, Rb^Tf, Rb^Tf, Qxua, Hhd^Em, Xu, Uh^Em, Kud, Rb^Fp, Qxua, Qxua, Rb^Fp, Kud, Uh^Em, Xu, Hhd^Em, Qxua, Rb^Tf, Rb^Tf, Rr, Gs^Es, Gs, Gs^Fp, Hh, Rr, Cud, Re, Ql, Qxua^Xo, Qxua^Xo, Qxua^Xo, Qxua^Xo
Qxua^Xo, Qxua^Xo, Qxua^Xo, Qxua^Xo, Re, Re, Rr, Rr, Gs^Fp, Gs, Rr, Rr, Re, Ur^Fp, Ur^Em, Ql, Rb^Tf, Xu, Xu, Rb^Tf, Xu, Uu^Em, Rb^Fp, Rb^Tf, Uh^Em, Cud, Rr, Ur, Uu, Uu^Em, Rr, Rr, Gg, Gg, Hh, Rr, Cud, Re, Ql, Qxua^Xo, Qxua^Xo, Qxua^Xo, Qxua^Xo, Qxua^Xo
Qxua^Xo, Qxua^Xo, Qxua^Xo, Re, Gs, Cud, Rr, Hh, Rr, Rr, Ur, Ur, Ur, Re, Ur, Ql, Qxua, Hhd^Em, Rr, Cud, Cud, Uu^Fp, Xu, Xu, Rr, Rr, Gs, Rr, Rr, Rr, Gg, Gg, Gg^Em, Gg^Fp, Rr, Rr, Re, Re, Qxua^Xo, Qxua^Xo, Qxua^Xo, Qxua^Xo, Qxua^Xo, Qxua^Xo
Qxua^Xo, Qxua^Xo, Ql, Re, Hh, Gs^Es, Gg, Rr, Re, Ur, Cud, Kud, Qxua, Re, Rr, Ur, Rr, Rr, Hhd, Hhd, Rb, Qxua, Uu, Uu, Rr, Gs^Fp, Hh^Em, Gs, Rr, Gs, Gs, Gs, Rr, Rr, Mm, Re, Qxua^Xo, Qxua^Xo, Qxua^Bs/, Cud, Qxua^Xo, Qxua^Xo, Qxua^Xo, Qxua^Xo
Qxua^Xo, Qxua^Xo, Ql, Re, Gs^Fp, Gs^Fp, Rr, Rr, Re, Ur, Qxua, Cud, Ql^Bs/, Cud, Re, Rr, Re, Qxua, Ql, Re^Fp, Ur, Cud, Cud, Qlf, Rr, Mm, Rb^Tf, Gg^Em, Gs, Rr, Rr, Rr, Gg, Gg^Em, Re, Re, Qxua^Xo, Cud, Qxua^Bs\, Qxua^Bs|, Qxua^Xo, Qxua^Xo, Qxua^Xo, Qxua^Xo
Qxua^Xo, Qxua^Xo, Qxua^Xo, Re, Gs, Gg^Em, Rr, Re, Kud, Ql, Ur, Kud, Rr, Hh, Mm, Re, Gg, Re, Re, Qxua, Qxu^Bs/, Kud, Rr, Rb^Tf, Rr, Hh^Em, Gg^Fp, Gg, Gg, Gs, Rr, Gs, Gg, Re, Ur, Uu^Fp, Ql, Qxua^Xo, Qxua^Xo, Cud, Qxua^Xo, Qxua^Xo, Qxua^Xo, Qxua^Xo
Qxua^Xo, Qxua^Xo, Qxua^Xo, Re, Re, Gg, Rr, Re, Rr, Cud, Rr, Rr, Gg^Fp, Rr, Gs, Gg, Rr, Rr, Rr^Vd, Re, Re, Re, Gs^Fp, Rr, Mm, Hh^Em, Rb^Tf, Gg^Em, Gs, Gg, Gg^Es, Rr, Gg, Re, Ur, Kud, Rb^Tf, Qxua^Xo, Qxua^Xo, Qxua^Xo, Qxua^Xo, Qxua^Xo, Qxua^Xo, Qxua^Xo
Qxua^Xo, Qxua^Xo, Qxua^Xo, Uu^Fp, Re, Rr^Vd, Re, Rr, Ur, Rr, Re, Gs^Es, Gs, Rr, Rr, Gs^Em, Rr, Gg, Gg, Rr, Rr, Gs^Es, Gg, Rr, Gg^Es, Gs^Fp, Gs, Gs, Rr, Gs, Rr^Vd, Rr, Gg, Re, Re, Cud, Uh, Qxua^Xo, Qxua^Xo, Qxua^Xo, Qxua^Xo, Qxua^Xo, Qxua^Xo, Qxua^Xo
Qxua^Xo, Qxua^Xo, Qxua^Xo, Uh, Rb^Tf, Re, Uu, Ur, Ql, Ur, Ur, Re, Re, Kud, Cud, Rr, Kud, Rr, Gg^Es, Gs, Gs^Fp, Kud, Cud, Rr, Rr, Gg, Gs, Rr, Hh, Rr, Gs, Gs, Gg, Gg^Em, Kud, Cud, Ql, Qxua^Xo, Qxua^Xo, Qxua^Xo, Qxua^Xo, Qxua^Xo, Qxua^Xo, Qxua^Xo
Qxua^Xo, Qxua^Xo, Qxua^Xo, Qxua^Xo, Qxua^Xo, Uh, Qxua^Xo, Uu^Fp, Uu^Fp, Qxua, Qxua, Uu^Vud, Re, Ql, Ur, Cud, Rr, Rr, Gg, Hh, Gs^Em, Cud, Re, Ur, Rr, Gg, Gg, Rr, Rb^Tf, Gs^Fp, Gg, Gg, Re, Re, Re, Uu, Qxua^Xo, Qxua^Xo, Qxua^Xo, Qxua^Xo, Qxua^Xo, Qxua^Xo, Qxua^Xo, Qxua^Xo
Qxua^Xo, Qxua^Xo, Qxua^Xo, Qxua^Xo, Qxua^Xo, Qxua^Xo, Cud, Qxua^Xo, Qxua^Xo, Rb^Tf, Uu, Ur, Ur^Em, Re, Re, Ur, Rr, Gg, Gs^Es, Gs, Re, Re, Ql, Ur, Ur, Rr, Gg, Rr, Rr, Gg^Em, Re, Re, Ur, Ur^Em, Rb^Tf, Re, Qxua^Xo, Cud, Qxua^Xo, Qxua^Xo, Qxua^Xo, Qxua^Xo, Qxua^Xo, Qxua^Xo
Uu, Qxua^Xo, Qxua^Xo, Qxua^Xo, Qxua^Xo, Qxua^Xo, Qxua^Xo, Qxua^Bs\, Cud, Qxua^Xo, Ql, Uu^Fp, Rb^Tf, Qxua, Cud, Re, Qxua, Cud, 2 Kud, Cud, Re, Qxua, Ur, Ql^Bs/, Ur, Rr, Gs^Fp, Hh, Gs^Em, Rr, Re, Ur^Fp, Ql, Cud, Ql, Ql, Qxua^Xo, Qxua^Bs|, Qxua^Xo, Qxua^Xo, Qxua^Xo, Qxua^Xo, Qxua^Xo, Qxua^Xo
Ql, Qxua^Xo, Qxua^Xo, Qxua^Xo, Qxua^Xo, Qxua^Xo, Qxua^Xo, Qxua^Xo, Qxua^Xo, Qxua^Xo, Qxua^Xo, Uu, Uu^Fp, Ql, Ql, Ql^Bs\, Ur^Em, Ur, Ur, Cud, Re, Ur, Uu^Vud, Qxua, Ur, Rr, Rr, Rb^Tf, Rr, Rr, Re, Ur, Cud, Kud, Qxua^Xo, Qxua^Xo, Qxua^Bs/, Cud, Qxua^Xo, Qxua^Xo, Qxua^Xo, Qxua^Xo, Qxua^Xo, Qxua^Xo
Uu^Fp, Ql, Qxua^Xo, Qxua^Xo, Qxua^Xo, Qxua^Xo, Qxua^Xo, Qxua^Xo, Qxua^Xo, Qxua^Xo, Qxua^Xo, Qxua^Xo, Qxua^Xo, Uu^Fp, Uu^Fp, Ur^Fp, Rb^Tf, Ql, Qxua, Ur^Em, Uu, Re, Re, Ur, Re, Re, Re, Rr^Vd, Re, Re, Uu^Fp, Uh, Ql, Ql, Qxua^Xo, Cud, Qxua^Xo, Qxua^Xo, Qxua^Xo, Qxua^Xo, Qxua^Xo, Qxua^Xo, Qxua^Xo, Qxua^Xo
Uu^Tf, Ql, Qxua^Xo, Qxua^Xo, Ql, Qxua^Xo, Qxua^Xo, Qxua^Xo, Qxua^Xo, Qxua^Xo, Qxua^Xo, Qxua^Xo, Qxua^Xo, Qxua^Xo, Qxua^Xo, Uu, Qxua^Xo, Uu^Fp, Uu^Fp, Rb^Tf, Qxua^Xo, Uu^Fp, Rb^Tf, Re, Rb^Tf, Uu^Fp, Uu^Fp, Re, Uu^Fp, Uu, Ql, Qxua^Xo, Qxua^Xo, Qxua^Xo, Qxua^Xo, Qxua^Xo, Qxua^Xo, Qxua^Xo, Qxua^Xo, Qxua^Xo, Qxua^Xo, Qxua^Xo, Qxua^Xo, Qxua^Xo
Uu^Fp, Uu^Fp, Uu^Fp, Rb^Tf, Ql^Bs\, Qxua^Xo, Qxua^Xo, Qxua^Xo, Qxua^Xo, Qxua^Xo, Qxua^Xo, Qxua^Xo, Qxua^Xo, Qxua^Xo, Qxua^Xo, Qxua^Xo, Cud, Qxua^Xo, Qxua^Xo, Qxua^Xo, Cud, Qxua^Xo, Qxua^Xo, Uu^Fp, Qxua^Xo, Ql, Qxua^Xo, Rb^Tf, Qxua^Xo, Ql, Qxua^Xo, Qxua^Xo, Qxua^Xo, Qxua^Xo, Qxua^Xo, Qxua^Xo, Qxua^Xo, Qxua^Xo, Qxua^Xo, Qxua^Xo, Qxua^Xo, Qxua^Xo, Qxua^Xo, Qxua^Xo
Uu^Fp, Ql, Ql, Ql, Uu^Em, Rb^Tf, Uu^Em, Cud, Qxua^Xo, Qxua^Xo, Qxua^Xo, Qxua^Xo, Qxua^Xo, Qxua^Xo, Qxua^Xo, Qxua^Xo, Qxua^Xo, Qxua^Bs\, Cud, Qxua^Bs/, Qxua^Xo, Qxua^Xo, Qxua^Xo, Qxua^Xo, Qxua^Xo, Qxua^Xo, Qxua^Xo, Qxua^Xo, Qxua^Xo, Qxua^Xo, Qxua^Xo, Qxua^Xo, Qxua^Xo, Qxua^Xo, Qxua^Xo, Qxua^Xo, Qxua^Xo, Qxua^Xo, Qxua^Xo, Qxua^Xo, Qxua^Xo, Qxua^Xo, Qxua^Xo, Qxua^Xo
Qxua^Xo, Qxua^Xo, Qxua^Xo, Qxua^Xo, Qxua^Xo, Qxua^Xo, Qxua^Xo, Qxua^Xo, Qxua^Xo, Qxua^Xo, Qxua^Xo, Qxua^Xo, Qxua^Xo, Qxua^Xo, Qxua^Xo, Qxua^Xo, Qxua^Xo, Qxua^Xo, Qxua^Xo, Qxua^Xo, Qxua^Xo, Qxua^Xo, Qxua^Xo, Qxua^Xo, Qxua^Xo, Qxua^Xo, Qxua^Xo, Qxua^Xo, Qxua^Xo, Qxua^Xo, Qxua^Xo, Qxua^Xo, Qxua^Xo, Qxua^Xo, Qxua^Xo, Qxua^Xo, Qxua^Xo, Qxua^Xo, Qxua^Xo, Qxua^Xo, Qxua^Xo, Qxua^Xo, Qxua^Xo, Qxua^Xo
