Wog, Wog, Wog, Wog, Wog, Wog, Wog, Wog, Wog, Wog, Wog, Wog, Wog, Wog, Wog, Wog, Wog, Wog, Wog, Wog, Wog, Wog, Wog, Wog, Wog, Wog, Wog, Wog, Wog, Wog, Wog, Wog, Wog, Wog, Wog, Wog, Wog, Wog, Wog, Wog, Wog, Wog, Wog, Wog, Wog, Wog
Wog, Wog, Wog, Wog, Wog, Wog, Wog, Wog, Wog, Wog, Wog, Wog, Wog, Wog, Wog, Wog, Wog, Wog, Wog, Wog, Wog, Wog, Wog, Wog, Wog, Wog, Wog, Wog, Wog, Wog, Wog, Wog, Wog, Wog, Wog, Wog, Wog, Wog, Wog, Wog, Wog, Wog, Wog, Wog, Wog, Wog
Wog, Wog, Wog, Wog, Wog, Wog, Wog, Wog, Wog, Wog, Wog, Wog, Wog, Wog, Wog, Wog, Wog, Wog, Wog, Wog, Wog, Wog, Wog, Wog, Wog, Wog, Wog, Wog, Wog, Wog, Wog, Wog, Wog, Wog, Wog, Wog, Wog, Wog, Wog, Wog, Wog, Wog, Wog, Wog, Wog, Wog
Wog, Wog, Wog, Wog, Wog, Wog, Wog, Wog, Wog, Wog, Wog, Wog, Wog, Wog, Wog, Wog, Wog, Wog, Wog, Wog, Wog, Wog, Wog, Wog, Wog, Wog, Wog, Wog, Wog, Wog, Wog, Wog, Wog, Wog, Wog, Wog, Wog, Wog, Wog, Wog, Wog, Wog, Wog, Wog, Wog, Wog
Wog, Wog, Wog, Wog, Wog, Wog, Wog, Wog, Wog, Wog, Wog, Wog, Wog, Wog, Wog, Rb, Rb, Gll, Gll, Wog, Rb, Rb, Md, Mv, Md, Wog, Wog, Wog, Wog, Wog, Wog, Wog, Wog, Wog, Wog, Wog, Wog, Wog, Wog, Wog, Wog, Wog, Wog, Wog, Wog, Wog
Wog, Wog, Wog, Wog, Wog, Wog, Wog, Wog, Wog, Wog, Wog, Wog, Gll, Wog, Md, Mv, Md, Sm, Sm, Sm, Md, Md, Md, Md, Md, Wog, Wog, Wog, Wog, Wog, Wog, Wog, Wog, Wog, Wog, Wog, Wog, Wog, Wog, Wog, Wog, Wog, Wog, Wog, Wog, Wog
Wog, Wog, Wog, Wog, Wog, Wog, Wog, Wog, Wog, Wog, Wog, Rb, Gll, Rb, Rb, Md, Rb, Gll, Md, Md, Md, Md, Md, Md, Rb, Rb, Wog, Wog, Wog, Wog, Wog, Wog, Wog, Wog, Wog, Wog, Wog, Wog, Wog, Wog, Wog, Wog, Wog, Wog, Wog, Wog
Wog, Wog, Wog, Wog, Wog, Wog, Wog, Wog, Wog, Wog, Wog, Wog, Gll, Gll, Rb, Rb, Wog, Gd, Gd, Md, Md, Mv, Md, Md, Gd, Wog, Wog, Wog, Wog^Xo, Wog^Xo, Wog^Xo, Wog, Wog, Wog, Wog, Wog, Wog, Wog, Wog, Wog, Wog, Wog, Wog, Wog, Wog, Wog
Wog, Wog, Wog, Wog, Wog, Wog, Wog, Wog, Wog, Wog, Wog, Wog, Wog^Xo, Wog^Xo, Wog^Xo, Wog^Xo, Wog^Xo, Gll, Rb, Hhd, Hhd, Md, Hhd, Hhd, Gll, Wog, Wog^Xo, Wog^Xo, Wo, Wo, Wo, Wog^Xo, Wog^Xo, Wog, Wog, Wog, Wog, Wog, Wog, Wog, Wog, Wog, Wog, Wog, Wog, Wog
Wog, Wog, Wog, Wog, Wog, Wog, Wog, Wog, Wog, Wog, Wog^Xo, Wog^Xo, Wo, Wo, Wo, Wo, Wo, Wog^Xo, Wog^Xo, Gll^Xo, Gll^Xo, Hhd, Gll, Rb, Wog^Xo, Wog^Xo, Wo, Wo, Gll^Es, Wwg, Gll, Wo, Wo, Wog^Xo, Wog^Xo, Wog, Wog, Wog, Wog, Wog, Wog, Wog, Wog, Wog, Wog, Wog
Wog, Wog, Wog, Wog, Wog, Wog, Wog, Wog, Wog^Xo, Wog^Xo, Wo, Wo, Gll, Wwg, Gll, Hhd, Gll, Wo, Wwg, Ai, Ai, Gll^Xo, Wog^Xo, Wog^Xo, Wwg, Wo, Gll^Es, Gll^Esd, Gd, Gll, Gll, Gll, Chr^Es, Wo, Wo, Wog^Xo, Wog^Xo, Wog, Wog, Wog, Wog, Wog, Wog, Wog, Wog, Wog
Wog, Wog, Wog, Wog, Wog, Wog, Wog^Xo, Wog^Xo, Wo, Wo, Ce^Es, Gll, Gll, Gll, Gll, Gll, Rb^Tf, Gll, Ms^Xm, Ms^Xm, Ms^Xm, Wwg, Ai, Ai, Ms^Xm, Rd^Es, Gll^Fdw, Gd, Rb^Vca, Hhd^Fdw, Gll, Gll, Gll^Es, Wwg, Wwg, Wo, Wo, Wog^Xo, Wog^Xo, Wog, Wog, Wog, Wog, Wog, Wog, Wog
Wog, Wog, Wog, Wog, Wog^Xo, Wog^Xo, Wo, Wo, Wwg, Gll^Es, Gll, Gd, Rb, Hhd^Fdw, Rb^Vhr, Gll, Gll^Es, Gll, Ms^Xm, Ms^Xm, Ms^Xm, Ms^Xm, Chw, Ms^Xm, Ms^Xm, Ms^Xm, Rd, Gd, Md, Rb, Rp, Gll, Gd^Fetd, Rb, Rb, Rb, Ds, Wo, Wog^Xo, Wog, Wog, Wog, Wog, Wog, Wog, Wog
Wog, Wog, Wog, Wog, Wog^Xo, Wo, Wwg, Hhd, Gll, Gll, Gll^Fdw, Gd, Gll, Rb^Es, Gd^Fetd, Gll, Gll^Es, Gll, Ms^Xm, Ms^Xm, Uu, Wwf, Wwf, Uu^Tf, Ms^Xm, Ms^Xm, Gll, Gd, Gd, Gll, Rp, Gll, Cea, Ce, Ce, Sm, Wwg, Wo, Wog^Xo, Wog, Wog, Wog, Wog, Wog, Wog, Wog
Wog, Wog, Wog, Wog, Wog^Xo, Wo, Gll, Gll, Gd, Gll, Cea^Es, Gll, Rp, Rp, Gll, Gd, Gd^Es, Hhd^Es, Rb, Uu, Uu, Wwf, Uu^Tf, Uu, Rb, Hhd^Es, Gll, Gd^Fetd, Gd, Gll^Es, Rp, Rb, Rb^Es, Cea^Es, 2 Ket, Wwg, Wwg^Bw/, Wo, Wog^Xo, Wog, Wog, Wog, Wog, Wog, Wog, Wog
Wog, Wog, Wog, Wog, Wog^Xo, Wo, Wwg, Gll, Cea, Cea, Gll, Rb, Gd, Gd, Gll, Gll, Gll, Gll^Es, Gll^Es, Rb, Ms^Xm, Ha, Ms^Xm, Rb, Gll, Gll, Gll, Gll, Md, Gll, Rp, Rb, Gll, Rb^Es, Rb^Es, Rb, Gll, Wwg, Wog^Xo, Wog, Wog, Wog, Wog, Wog, Wog, Wog
Wog, Wog, Wog, Wog, Wog^Xo, Wo, Wwg, Gll^Es, 1 Kea, Rb^Es, Gll, Rp, Hhd, Md, Gd, Gd, Rb, Gll, Gll, Gll, Wwg, Ms^Xm, Ms^Xm, Ms^Xm, Gll, Gll, Gd, Gd, Rb^Vha, Rb, Rp, Rb^Es, Rp, Gll, Gll, Gd, Gll, Wo, Wwg, Wog^Xo, Wog^Xo, Wog, Wog, Wog, Wog, Wog
Wog, Wog, Wog, Wog^Xo, Wo, Wo, Wwg^Bw\, Gll, Cea, Gll^Es, Gll, Rp, Rb, Rb^Vla, Rb, Gd, Hhd, Gll, Gll^Fdw, Gll^Em, Gll^Tf, Ai, Ms^Xm, Ms^Xm, Cha^Es, Gll, Gll, Rb^Tf, Gd, Rb, Rp, Cha^Es, Gll^Es, Rr, Rp, Gll^Es, Gll, Gll, Wwg^Vm, Wo, Wo, Wog^Xo, Wog, Wog, Wog, Wog
Wog, Wog, Wog^Xo, Wog^Xo, Wo, Wwg, Gll, Rb, Gll^Es, Gll, Gll, Rp, Rp, Rb, Rb, Rb, Ms^Xm, Rb, Gll, Gll, Cea^Es, Ai, Ai, Ai, Ai, Rb, Hd, Gd, Gd, Gll, Rp, Gd^Dr, Gd, Gll, Rp^Es, Chr^Es, Khr^Es, Gll, Wwf, Wwf^Dr, Wo, Wog^Xo, Wog, Wog, Wog, Wog
Wog, Wog, Wog^Xo, Wo, Wwg, Cea^Es, Gd, Rb, Rb, Gll, Gll, Gll, Gll, Rp, Mm, Ms^Xm, Ms^Xm, Ms^Xm, Gll, Rb, Ai, Ai, Ms^Xm, Ms^Xm, Ms^Xm, Ai, Rb, Gll, Gll, Gll, Rr, Gll, Gll^Fdw, Rp^Vhhr, Rr, Gd, Gll, Gll, Gd, Wwg, Wo, Wog^Xo, Wog^Xo, Wog, Wog, Wog
Wog, Wog, Wog^Xo, Wo, Wwg, Gll, Gd, Cea^Es, Rr, Gd, Gll, Khr^Es, Rr, Rr, Rp, Ms^Xm, Hhd, Mm, Gll, Hd, Rb, Ai, Ai, Ms^Xm, Ms^Xm, Ai, Rb, Gll, Rp^Vhcr, Hhd^Fdw, Rr, Gll, Gd, Gd, Rp, Gll, Rd, Rd, Rb, Wwf, Gll, Wo, Wo, Wog^Xo, Wog^Xo, Wog
Wog, Wog, Wog^Xo, Wo, Wwf, Wwg^Vm, Gll, Gll, Rp, Gll^Vhr, Rp, Cha, Gll, Gll^Es, Gll, Rp, Rp, Gll, Gll, Gll, Gll^Em, Rb, Ds, Ai, Ai, Ai, Ds, Gll^Tf, Gd, Rp, Gll^Fetd, Rp, Gll, Gll, Gll^Es, Rp, Cha^Es, Wwg, Wwf, Wwf, Hhd, Gll, Gll, Wo, Wog^Xo, Wog
Wog, Wog, Wog^Xo, Wo, Gll, Wwf^Dr, Wwf, Gll, Wwg, Rp, Gll, Rr, Wwg^Bsb\, Gll, Gll, Gll, Rr, Rr, Rp, Gll, Gll^Vhr, Gll^Tf, Gll, Rb, Ms^Xm, Ai, Ms^Xm, Rb, Gll, Gd, Rp, Rr, Gll, Gll, Rd^Es, Cha^Es, Cha^Es, Khr^Es, Chw, Rd, Sm, Wwg, Ai, Wo, Wog^Xo, Wog
Wog, Wog, Wog^Xo, Wo, Gll, Gll, Gd, Sm, Sm^Dr, Sm, Gll, Gd, Wwf^Es, Chw, Chw, Wwg^Bsb/, Rb, Gll, Rp, Hhd^Fdw, Gll, Gd^Em, Gll, Gll^Fdw, Gd^Tf, Wwg, Wog, Ms^Xm, Gll, Gll^Em, Rr, Gll, Gll, Hhd, Rd, Wwg, Wwf, Wwg^Bw\r, Rd^Es, Rd, Wwg, Sm, Sm, Wo, Wog^Xo, Wog
Wog, Wog, Wog^Xo, Wo, Gll, Gll, Gd, Gll, Gll, Wwg, Gll, Gll, Wwf^Es, Khr^Es, Chw^Es, Cha^Es, Gll, Gd^Fdw, Rr, Rr, Rr, Gll, Rp, Gll, Rr, Gll, Wwg, Wwg, Gll, Gll^Tf, Rp, Gll, Gll, Gll, Rp, Rd, Rd, Wwg^Es, Wwf, Gd, Gll, Sm, Gll, Wo, Wog^Xo, Wog
Wog, Wog, Wog^Xo, Wo, Gll, Rb^Dr, Md^Xm, Gd, Gd, Wwf, Gll, Gll, Gll^Fdw, Wwg^Bsb|, Wwg^Es, Wwf, Rr, Rp, Rp, Ms, Rb^Fdw, Rp, Gll, Rr, Gll, Rp, Rp, Rp, Rp, Rr, Gll, Rp, Rp, Rp, Gll, Rd, Rp, Gll^Fdw, Gd, Wwf, Wwf, Gll, Gll, Wo, Wog^Xo, Wog
Wog, Wog, Wog^Xo, Wo, Wwf, Md, Ms, Md^Xm, Gll, Wwf, Wwf, Gd, Gll, Rr, Gll, Wwf, Wwf^Es, Wwf, Rp, Gll, Gll, Gll, Gll, Gll, Gll, Ms^Xm, Ms^Xm, Ms^Xm, Gd^Dr, Gll^Es, Gll, Gll, Gd^Vhcr, Ds, Hhd^Fdw, Gll, Gll, Rp, Gd^Vhhr, Gll^Fdw, Wwf, Gll, Cea, Wo, Wog^Xo, Wog
Wog, Wog, Wog, Wog^Xo, Wog^Xo, Wwg, Wwf, Gll, Gll, Rb^Fdw, Wwf^Vhcr, Gll, Gll, Rr, Hhd^Fdw, Gll, Gll, Gll, Ds, Gll, Gll, Gd, Gll, Hhd, Gll, Gll, Gll, Gd^Es, Gll^Es, Gd, Gll, Gll^Fdw, Gd, Gd, Gd, Gll, Gll, Gd^Es, Chw^Es, Gd, Wwf, Gll, Wwg, Wo, Wog^Xo, Wog
Wog, Wog, Wog, Wog, Wog, Wog^Xo, Wog^Xo, Wo, Wo, Wwg, Chw^Es, Gll, Gll, Rp, Gll, Gll, Gd, Gll, Hhd^Fdw, Gd^Vhhr, Gd^Fetd, Gll, Gll, Gll, Cha, Gll, Rd, Cha^Es, Rd, Gd, Gll, Gll, Gll, Gll, Gd, Gll, Hhd, Gd, Gd^Es, Gll, Wwg, Wwg, Wog^Xo, Wog^Xo, Wog, Wog
Wog, Wog, Wog, Wog, Wog, Wog, Wog, Wog^Xo, Wog^Xo, Wwg, Gll, Gll, Gll^Fda, Gll, Md, Gd, Gd, Gd, Gll, Gd, Gll, Gll, Gd, Gll, Gll, Rd, Gll, Rd, Rd^Fetd, Rd, Rd, Gll, Gll^Tf, Gd, Gll, Gll, Gll^Fdw, Gll, Gll^Es, Rb^Dr, Wo, Wog^Xo, Wog, Wog, Wog, Wog
Wog, Wog, Wog, Wog, Ai, Wog, Wog, Wog, Wog^Xo, Wo, Wo, Gll, Gd, Gll, Gll, Gll, Hhd, Gll, Gll, Gd, Gll, Gll, Gll, Gd^Fdw, Rd, Gll, Gll^Tf, Rd, Rd, Rd, Ai, Gll, Gll, Gll, Rd, Gll, Gd^Em, Gll, Gll, Wwg, Wog^Xo, Wog^Xo, Wog, Wog, Wog, Wog
Wog, Wog, Wog, Ai, Ai, Wog, Wog, Wog, Wog, Wog^Xo, Wo, Gll, Rd, Gll, Gd, Gll^Fetd, Gll, Gll, Gll^Es, Rb^Dr, Gll, Gll, Rd, Gll, Gll, Gll, Gll, Gll, Gll, Gll, Gll, Wog, Wwg^Bw/r, Rd, Hd, Rd, Wwf^Vhs, Gll^Tf, Gll, Wo, Wog^Xo, Wog, Wog, Wog, Wog, Wog
Wog, Wog, Wog, Ai, Wog, Wog, Wog, Wog, Wog, Wog^Xo, Wo, Hd, Chw^Es, Gll, Gd, Gll, Gd, Gll, Gll, Gll^Es, Gll, Gll^Tf, Gll, Ai, Wwf, Gll^Es, Cha^Es, Khr^Es, Gd, Gd, Gll, Gll, Rd, Wwg, Wwg, Rb, Cea, Sm, Wo, Wo, Wog^Xo, Wog, Wog, Wog, Wog, Wog
Wog, Wog, Wog, Wog, Wog, Wog, Wog, Wog, Wog, Wog^Xo, Wog^Xo, Wo, Wo, Wwg, Rb, Gd^Vhr, Chr, Gll, Mm^Xm, Hhd^Fdw, Hhd^Es, Gll, Gd, Gll, Wwf, Gll^Es, Gll, Gd^Fdw, Gd, Gd, Gll, Rd, Hd^Fdw, Wwg, Wo, Wwf, Wo, Wo, Wog^Xo, Wog^Xo, Wog, Wog, Wog, Wog, Wog, Wog
Wog, Wog, Wog, Wog, Wog, Wog, Wog, Wog, Wog, Wog, Wog, Wog^Xo, Wog^Xo, Wo, Wo, Wwg, Uue^Tf, Wwf, Wwf, Mm^Xm, Mm^Xm, Gd, Rd, Rd, Wwf, Gll, Gd, Gll, Rd, Chr^Es, Gd, Rd, Wo, Wo, Wog^Xo, Wo, Wog^Xo, Wog^Xo, Wog, Wog, Wog, Wog, Wog, Wog, Wog, Wog
Wog, Wog, Wog, Wog, Wog, Wog, Wog, Wog, Wog, Wog, Wog, Wog, Wog, Wog^Xo, Wog^Xo, Wo, Ms^Xm, Uue^Em, Wwf^Es, Uh^Es, Wwf, Rb, Rb, Hd, Wo, Gd^Dr, Rd, Rd, Hd^Fdw, Rd, Rd, Gll, Wo, Wog^Xo, Wog, Wog^Xo, Wog, Wog, Wog, Wog, Wog, Wog, Wog, Wog, Wog, Wog
Wog, Wog, Wog, Wog, Wog, Wog, Wog, Wog, Wog, Wog, Wog, Wog, Wog, Wog, Wog^Xo, Ww, Ai, Ms^Xm, Ms^Xm, Wwf, Ms, Wwf, Wo, Wo, Wog^Xo, Wo, Rb, Hd, Hd, Wo, Rb^Fdw, Wo, Wog^Xo, Wog^Xo, Wog, Wog, Wog, Wog, Wog, Wog, Wog, Wog, Wog, Wog, Wog, Wog
Wog, Wog, Wog, Wog, Wog, Ai, Ai, Ai, Ai, Wog, Wog, Wog, Wog, Wog, Wog, Wog^Xo, Wog^Xo, Ai, Ww, Ai, Wo, Wo, Wog^Xo, Wog^Xo, Wog^Xo, Wo, Wo, Wo, Wo, Wo, Wo, Wo, Wog^Xo, Wog, Wog, Wog, Wog, Wog, Wog, Wog, Wog, Wog, Wog, Wog, Wog, Wog
Wog, Wog, Ai, Ai, Ai, Wog, Wog, Ai, Ai, Ai, Wog, Wog, Wog, Wog, Wog, Wog, Wog, Wog^Xo, Wog^Xo, Wog^Xo, Wog^Xo, Wog^Xo, Wog, Wog, Wog, Wog^Xo, Wog^Xo, Wog^Xo, Wog^Xo, Wog^Xo, Wog^Xo, Wog^Xo, Wog, Wog, Wog, Wog, Wog, Wog, Wog, Wog, Wog, Wog, Wog, Wog, Wog, Wog
Wog, Wog, Ai, Wog, Ai, Ai, Ai, Ai, Wog, Ai, Wog, Wog, Wog, Wog, Wog, Wog, Ai, Ai, Ai, Wog, Ai, Wog, Wog, Wog, Wog, Wog, Ai, Wog, Wog, Ai, Ai, Wog, Wog, Ai, Ai, Wog, Wog, Wog, Wog, Wog, Wog, Wog, Wog, Wog, Ai, Wog
Wog, Wog, Wog, Ai, Ai, Ai, Wog, Ai, Ai, Wog, Wog, Ai, Wog, Wog, Ai, Ai, Ai, Wog, Wog, Wog, Wog, Wog, Wog, Wog, Wog, Wog, Wog, Wog, Wog, Ai, Ai, Ai, Wog, Ai, Wog, Wog, Wog, Wog, Wog, Wog, Wog, Wog, Wog, Ai, Ai, Ai
Wog, Wog, Wog, Wog, Wog, Wog, Wog, Wog, Wog, Wog, Ai, Ai, Wog, Ai, Ai, Ai, Wog, Ai, Wog, Ai, Ai, Ai, Ai, Wog, Wog, Ai, Ai, Ai, Wog, Ai, Wog, Ai, Ai, Wog, Ai, Ai, Ai, Wog, Ai, Wog, Ai, Ai, Wog, Ai, Ai, Wog
