border_size=1
usage=map

Ql^Ii       , Ql^Ii       , Ql^Ii       , Xu          , Xu          , Xu          , Uu          , Ds          , Ur^Fdw      , Ur^Fdw      , Ur^Dr       , Ur          , Ur          , Ur          , Ur          , Ur          , Wo          , Wo          , Ur          , Hh          , Hh          , Xu          , Xu          , Xu          , Xu          , Xu          , Xu          , Xu          , Xu          , Xu          , Xu          , Xu          
Xu          , Ql^Ii       , Xu          , Ql^Ii       , Xu          , Qxu         , Uu          , Ds          , Ur          , Ur^Fdw      , Ur          , Ur          , Cud         , Ur          , Cud         , Ur          , Wwf         , Wo          , Ur          , Hh^Fmw      , Hh^Fmw      , Xu          , Xu          , Xu          , Xu          , Xu          , Xu          , Xu          , Xu          , Xu          , Xu          , Xu          
Xu          , Xu          , Qxu         , Xu          , Xu          , Ur          , Qxu         , Uu          , Ur          , Ur          , Ur          , Cud         , Cud         , 2 Kud       , Cud         , Cud         , Ww          , Uu^Vud      , Ur          , Hh^Fmw      , Ds          , Xu          , Ur          , Xu          , Hh^Fmw      , Xu          , Xu          , Xu          , Xu          , Xu          , Xu          , Xu          
Qxu         , Qxu         , Uu^Fdw      , Qxu         , Qxu         , Qxu^Bw|     , Qxu^Bw/     , Ur          , Ur          , Hh          , Hh          , Ur          , Ur          , Cud         , Ur          , Wwf         , Ur          , Wwf         , Wo          , Ur          , Ur          , Ur          , Ur          , Ur^Fmw      , Ur^Fmw      , Xu          , Xu          , Xu          , Xu          , Xu          , Xu          , Xu          
Uu          , Uu^Fdw      , Ur          , Uu          , Ur          , Ur          , Qxu^Bw/     , Qxu^Bw|     , Uu          , Hh^Fdw      , Ur          , Ur          , Ur          , Ur          , Ur          , Ur          , Dd^Dc       , Ww          , Wwf         , Ww          , Ur          , Chw         , Wwf         , Ur          , Ur          , Uh          , Xu          , Uh          , Hh^Fdw      , Xu          , Xu          , Xu          
Uh          , Ds          , Ur          , Ur          , Uu^Vud      , Uu^Fdw      , Rp          , Qxu         , Ur          , Ur          , Uu          , Uu          , Uu          , Ur          , Ur^Fdw      , Ur          , Wwf         , Wwf         , Wwf         , Ur          , Wwf         , Khw         , Wwf         , Uu^Vu       , Ur          , Uh          , Ds          , Uh          , Uu^Vud      , Ur          , Ur          , Xu          
Ds^Fdw      , Ds          , Ur          , Ur          , Ur          , Rp          , Ur          , Qxu^Bw/     , Qxu^Bw/     , Ur          , Qxu         , Qxu         , Uu          , Ur^Fdw      , Ur          , Uu^Vud      , Ur          , Ur          , Ww          , Wwf         , Uh          , Wwf         , Wwf         , Ur          , Ur          , Ur          , Ur          , Ur          , Ur          , Ur          , Xu          , Xu          
Ur^Fdw      , Ur^Fdw      , Ur^Fdw      , Ur          , Ur          , Ur          , Uu^Uf       , Re          , Qxu^Bw|     , Qxu^Bw|     , Ur          , Qxu^Bs/     , Uu^Uf       , Uu          , Hh          , Ur          , Ur          , Ur          , Ur^Fdw      , Ur          , Ur          , Wwf         , Wo          , Wo          , Ur^Fdw      , Ur          , Hh          , Ur          , Ur          , Ur          , Ur^Fdw      , Xu          
Hh          , Hh^Fdw      , Ur          , Ur          , Ds          , Ur          , Ur          , Re^Vct      , Ur          , Ur          , Qxu^Bw\     , Qxu         , Uu^Fdw      , Uu^Uf       , Ur          , Ur          , Uu^Uf       , Ur^Fdw      , Hh          , Ur          , Ur          , Re^Vct      , Wwf         , Wwf         , Ur          , Hh^Fdw      , Ur          , Ur          , Khr         , Ur          , Ur          , Xu          
Uu          , Ur          , Ur          , Ur          , Uu^Uf       , Uh          , Ur          , Ur          , Uu          , Uu          , Qxu^Bw\     , Re          , Ur^Fmw      , Ur          , Ur          , Ur          , Qxu         , Uu          , Ur          , Ur          , Uu^Uf       , Uu^Ufi      , Wwf         , Wwf         , Wo          , Wwf         , Ww          , Chw         , Ur          , Ur          , Hh          , Uu          
Uu          , Uu^Vud      , Wwf         , Ur          , Ur^Fdw      , Ur^Fdw      , Ur          , Ur          , Uu^Uf       , Qxu         , Uu          , Re          , Uu          , Ur          , Ur          , Qxu^Bs\     , Uu          , Qxu^Bs/     , Ur          , Ur          , Qxu         , Wo          , Xu          , Wwf^Fdw     , Gs^Fdw      , Ur          , Wwf         , Chw         , Ur          , Hh          , Ur^Fmw      , Hh^Fmw      
Uu          , Uu          , Ur          , Wwf         , Chw         , Wwf         , Ur          , Ur          , Uu          , Qxu         , Qxu         , Qxu^Bw|     , Qxu^Bs|     , Qxu         , Qxu^Bw|     , Qxu^Bw\     , Rd          , Qxu^Bw/     , Qxu         , Qxu^Bw\     , Rd          , Qxu         , Xu          , Gs^Fdw      , Ur^Fdw      , Ur          , Wwf         , Ur          , Wwf         , Ur          , Ur          , Hh^Fmw      
Uu^Uf       , Uh          , Ur          , Ww          , Wwf         , Ur          , Hh          , Ur          , Qxu^Bw\     , Qxu^Bs\     , Hh          , Rd          , Uu          , Uu          , Rd          , Uu          , Rd          , Uu          , Uu^Dr       , Uu          , Uu^Fp       , Qxu         , Qxu         , Xu          , Uh          , Ur          , Ur          , Ww          , Wwf         , Ur          , Wwf         , Ur          
Wwf^Fmw     , Ur^Fmw      , Wwf         , Wwf         , Ur          , Ur          , Hh^Fdw      , Xu          , Qxu         , Rd          , Rd          , Chr         , Rd^Fp       , Rd          , Hh          , Hh^Fmw      , Xu          , Rd          , Rd          , Rd          , Rd          , Uh          , Qxu         , Xu          , Xu          , Ur^Fdw      , Hh          , Ur          , Wo          , Wwf         , Wwf^Fmw     , Ww          
Ww          , Wwf^Fmw     , Wwf         , Wo          , Ur          , Hh          , Ur^Fdw      , Xu          , Xu          , Qxu         , Uh          , Rd          , Rd          , Rd          , Rd          , Xu          , Hh^Fmw      , Hh          , Rd          , Rd^Fp       , Chr         , Rd          , Rd          , Qxu         , Xu          , Hh^Fdw      , Ur          , Ur          , Wwf         , Wwf         , Ur^Fdw      , Wwf^Fmw     
Ur          , Wwf         , Ur          , Wwf         , Ww          , Ur          , Ur          , Uh          , Xu          , Qxu         , Qxu         , Uu^Fp       , Uu          , Uu^Dr       , Uu          , Rd          , Uu          , Rd          , Uu          , Uu          , Rd          , Hh          , Qxu^Bs\     , Qxu^Bw\     , Ur          , Hh          , Ur          , Wwf         , Ww          , Ur          , Uh          , Uu^Uf       
Hh^Fmw      , Ur          , Ur          , Wwf         , Ur          , Wwf         , Ur          , Ur^Fdw      , Gs^Fdw      , Xu          , Qxu         , Rd          , Qxu^Bw\     , Qxu         , Qxu^Bw/     , Rd          , Qxu^Bw\     , Qxu^Bw|     , Qxu         , Qxu^Bs|     , Qxu^Bw|     , Qxu         , Qxu         , Uu          , Ur          , Ur          , Wwf         , Chw         , Wwf         , Ur          , Uu          , Uu          
Hh^Fmw      , Ur^Fmw      , Hh          , Ur          , Chw         , Wwf         , Ur          , Gs^Fdw      , Wwf^Fdw     , Xu          , Wo          , Qxu         , Ur          , Ur          , Qxu^Bs/     , Uu          , Qxu^Bs\     , Ur          , Ur          , Uu          , Re          , Uu          , Qxu         , Uu^Uf       , Ur          , Ur          , Ur^Fdw      , Ur^Fdw      , Ur          , Wwf         , Uu^Vud      , Uu          
Uu          , Hh          , Ur          , Ur          , Chw         , Ww          , Wwf         , Wwf         , Wwf         , Wwf         , Uu^Ufi      , Uu^Uf       , Ur          , Ur          , Uu          , Qxu         , Ur          , Ur          , Ur          , Ur^Fmw      , Re          , Qxu^Bw\     , Uu          , Uu          , Ur          , Ur          , Uh          , Uu^Uf       , Ur          , Ur          , Ur          , Uu          
Xu          , Ur          , Ur          , Khr         , Ur          , Ur          , Hh^Fdw      , Ur          , Wwf         , Wwf         , Re^Vct      , Ur          , Ur          , Hh          , Ur^Fdw      , Uu^Uf       , Ur          , Ur          , Uu^Uf       , Ur^Fdw      , Qxu         , Qxu^Bw\     , Ur          , Ur          , Re^Vct      , Ur          , Ur          , Ds          , Ur          , Ur          , Hh^Fdw      , Hh          
Xu          , Ur^Fdw      , Ur          , Ur          , Ur          , Hh          , Ur          , Ur^Fdw      , Wo          , Wo          , Wwf         , Ur          , Ur          , Ur^Fdw      , Ur          , Ur          , Ur          , Hh          , Uu          , Uu^Uf       , Qxu^Bs/     , Ur          , Qxu^Bw|     , Qxu^Bw|     , Re          , Uu^Uf       , Ur          , Ur          , Ur          , Ur^Fdw      , Ur^Fdw      , Ur^Fdw      
Xu          , Xu          , Uu^Vud      , Ur          , Ur          , Ur          , Ur          , Ur          , Ur          , Wwf         , Wwf         , Uh          , Wwf         , Ww          , Ur          , Ur          , Uu^Vud      , Ur          , Ur^Fdw      , Uu          , Qxu         , Qxu         , Ur          , Qxu^Bw/     , Qxu^Bw/     , Ur          , Rp          , Ur          , Ur          , Ur          , Ds          , Ds^Fdw      
Xu          , Xu          , Ur          , Ur          , Uh          , Ds          , Uh          , Ur          , Uu^Vu       , Wwf         , Khw         , Ww          , Ur          , Wwf         , Wwf         , Wwf         , Ur          , Ur^Fdw      , Ur          , Uu          , Uu          , Uu          , Ur          , Ur          , Qxu         , Rp          , Uu^Fdw      , Uu^Vud      , Ur          , Ur          , Ds          , Uh          
Xu          , Xu          , Xu          , Hh^Fdw      , Uh          , Xu          , Uh          , Ur          , Ur          , Wwf         , Chw         , Ur          , Ww          , Wwf         , Ww          , Dd^Dc       , Ur          , Ur          , Ur          , Ur          , Ur          , Ur          , Hh^Fdw      , Uu          , Qxu^Bw|     , Qxu^Bw/     , Ur          , Ur          , Uu          , Ur          , Uu^Fdw      , Uu          
Xu          , Xu          , Xu          , Xu          , Xu          , Xu          , Xu          , Ur^Fmw      , Ur^Fmw      , Ur          , Ur          , Ur          , Ur          , Wo          , Wwf         , Ur          , Wwf         , Ur          , Cud         , Ur          , Ur          , Hh          , Hh          , Ur          , Ur          , Qxu^Bw/     , Qxu^Bw|     , Qxu         , Qxu         , Uu^Fdw      , Qxu         , Qxu         
Xu          , Xu          , Xu          , Xu          , Xu          , Xu          , Xu          , Hh^Fmw      , Xu          , Ur          , Xu          , Ds          , Hh^Fmw      , Ur          , Uu^Vud      , Ww          , Cud         , Cud         , 1 Kud       , Cud         , Cud         , Ur          , Ur          , Ur          , Uu          , Qxu         , Ur          , Xu          , Xu          , Qxu         , Xu          , Xu          
Xu          , Xu          , Xu          , Xu          , Xu          , Xu          , Xu          , Xu          , Xu          , Xu          , Xu          , Hh^Fmw      , Hh^Fmw      , Ur          , Wo          , Wwf         , Ur          , Cud         , Ur          , Cud         , Ur          , Ur          , Ur^Fdw      , Ur          , Ds          , Uu          , Qxu         , Xu          , Ql^Ii       , Xu          , Ql^Ii       , Xu          
Xu          , Xu          , Xu          , Xu          , Xu          , Xu          , Xu          , Xu          , Xu          , Xu          , Xu          , Hh          , Hh          , Ur          , Wo          , Wo          , Ur          , Ur          , Ur          , Ur          , Ur          , Ur^Dr       , Ur^Fdw      , Ur^Fdw      , Ds          , Uu          , Xu          , Xu          , Xu          , Ql^Ii       , Ql^Ii       , Ql^Ii       
