Hh          , Hh          , Gg          , Gg          , Gg          , Hh          , Gg          , Gg          , Hh          , Hh          , Gg          , Gg          , Gg          , Wwf         , Wwf         , Wwf         , Hh          , Hh          , Hh          , Hh          , Mm          , Hh          , Mm          
Hh          , Hh          , Gg          , Gll^Fp      , Gll^Fp      , Hh          , Mm          , Gll^Fp      , Gg          , Hh          , Gg          , Gg          , Gg          , Wwf         , Ww          , Wwf         , Hh          , Hh          , Gll^Fp      , Hh          , Mm          , Mm          , Hh          
Gg          , Gg          , Gg          , Gg^Ve       , Gg          , Hh          , Gg          , Gg^Ve       , Gg          , Gg          , Ch          , Ch          , Ch          , Wwf         , Ww          , Wwf         , Gll^Fp      , Mm          , Gg          , Gll^Fp      , Gll^Fp      , Hh          , Mm          
Gll^Fp      , Gll^Fp      , Gg          , Gg          , Gg          , Mm          , Gll^Fp      , Gg          , Gg          , Gg          , Ch          , 1 Kh        , Ch          , Wwf         , Ww          , Wwf         , Gll^Fp      , Mm          , Gg          , Gll^Fp      , Gs^Vh       , Mm          , Hh          
Hh          , Hh          , Mm          , Gg          , Gg          , Gg          , Gg          , Gg          , Rb          , Rb          , Gg          , Ch          , Wwf         , Rb          , Ww^Bw\      , Gg          , Gg          , Gg          , Gg          , Gg          , Gll^Fp      , Hh          , Mm          
Gll^Fp      , Gll^Fp      , Hh          , Gg          , Gg          , Gg          , Rb          , Rb          , Gg          , Mm          , Wwf         , Wwf         , Ww          , Ww          , Gg          , Rb          , Rb          , Gg          , Gg          , Gg          , Gg          , Mm          , Rb          
Mm          , Mm          , Gg          , Gg          , Rb          , Rb          , Gg          , Gg          , Gg          , Gll^Fp      , Wwf         , Ww          , Gg          , Gg          , Ss          , Ss          , Ss          , Rb          , Rb          , Gs^Vh       , Rb          , Rb          , Gg          
Hh          , Hh          , Hh          , Rb          , Gg          , Gg          , Gg          , Gg          , Hh          , Gs^Vh       , Wwf         , Ww          , Gg          , Ss          , Ss          , Ss^Vhs      , Ss          , Hh          , Mm          , Rb          , Gs^Vh       , Gg          , Rb          
Gll^Fp      , Gll^Fp      , Mm          , Rb          , Gll^Fp      , Gg^Ve       , Hh          , Gll^Fp      , Gll^Fp      , Mm          , Wwf         , Ww          , Wwf         , Gg          , Ss          , Ss          , Mm          , Gll^Fp      , Gg          , Rb          , Rb          , Rb          , Rb          
Mm          , Mm          , Mm          , Rb          , Gll^Fp      , Mm          , Gll^Fp      , Mm          , Wwf         , Wwf         , Ww          , Ww^Vm       , Ww          , Gg          , Gg          , Ss          , Ss          , Hh          , Wwf         , Rb          , Wwf         , Rb          , Rb          
Gll^Fp      , Gll^Fp      , Wwf         , Rb          , Hh          , Gll^Fp      , Gg          , Wwf         , Ww          , Ww          , Wo          , Wo          , Wo          , Ww          , Ww          , Gg          , Gll^Fp      , Gll^Fp      , Wwf         , Ww^Bw|      , Wwf         , Rb          , Wwf         
Wwf         , Wwf         , Wwf         , Rb          , Gg          , Gg          , Gg          , Wwf         , Ww          , Wo          , Wo          , Wo          , Wo          , Wo          , Ww          , Wwf         , Gg          , Gg          , Mm          , Rb          , Wwf         , Wwf         , Gg          
Rb          , Rb          , Wwf         , Rb          , Wwf         , Gg          , Mm          , Wwf         , Ww          , Wo          , Wo          , Wo          , Wo          , Wo          , Ww          , Wwf         , Gg          , Gg          , Hh          , Rb          , Gg          , Gg          , Mm          
Rb          , Rb          , Rb          , Ww^Bw|      , Wwf         , Gll^Fp      , Ss          , Gg          , Gg          , Ww          , Ww          , Wo          , Ww          , Ww          , Wwf         , Wwf         , Gll^Fp      , Hh          , Mm          , Rb          , Gll^Fp      , Mm          , Gg          
Hh          , Hh          , Rb          , Rb          , Rb          , Hh          , Gll^Fp      , Ss          , Ss          , Gg          , Wwf         , Ww^Vm       , Wwf         , Wwf         , Md          , Md          , Hh          , Gll^Fp      , Mm          , Rb          , Gll^Fp      , Gll^Fp      , Gg          
Rb          , Rb          , Gs^Vh       , Rb          , Gll^Fp      , Mm          , Ss          , Ss          , Ss          , Gg          , Gg          , Ww          , Wwf         , Gll^Fp      , Hh          , Gll^Fp      , Gg          , Gg          , Gg          , Rb          , Gg          , Hh          , Gg          
Gg          , Gg          , Rb          , Rb          , Rb          , Hh          , Ss          , Ss^Vhs      , Ss          , Ss          , Gg          , Ww          , Wwf         , Gg^Ve       , Gg          , Gg          , Gg          , Gg          , Rb          , Rb          , Gg          , Gll^Fp      , Hh          
Rb          , Rb          , Gg          , Gg          , Gg          , Rb          , Rb          , Ss          , Gg          , Gg          , Ww          , Ww          , Wwf         , Mm          , Gg          , Gg          , Rb          , Rb          , Gg          , Gg          , Hh          , Hh          , Gg          
Gll^Fp      , Gll^Fp      , Mm          , Gg          , Gg          , Gg          , Mm          , Rb          , Ww^Bw\      , Ww          , Wwf         , Wwf         , Gg          , Gll^Fp      , Rb          , Rb          , Gg          , Gg          , Gg          , Gll^Fp      , Mm          , Gll^Fp      , Gg          
Hh          , Hh          , Gs^Vh       , Gg          , Hh          , Gll^Fp      , Mm          , Gg          , Ww          , Rb          , Ch          , Ch          , Ch          , Rb          , Gg          , Gg          , Gg          , Gg          , Gg          , Gg          , Gg          , Gll^Fp      , Gg          
Mm          , Mm          , Hh          , Mm          , Hh          , Gll^Fp      , Wwf         , Wwf         , Ww          , Wwf         , Ch          , 2 Kh        , Ch          , Gg          , Gg          , Gg          , Mm          , Gs^Vh       , Gg          , Gg          , Gg          , Gg          , Mm          
Gg          , Gll^Fp      , Gll^Fp      , Hh          , Gll^Fp      , Wwf         , Ww          , Ww          , Ww          , Wwf         , Gg          , Ch          , Gg          , Gs^Vh       , Gll^Fp      , Gll^Fp      , Hh          , Hh          , Gll^Fp      , Gg          , Hh          , Mm          , Mm          
Gg          , Gg          , Gg          , Gg          , Gg          , Wwf         , Ww          , Ww          , Ww          , Wwf         , Gg          , Gg          , Gg          , Gg          , Gg          , Gg          , Gg          , Hh          , Gll^Fp      , Gg          , Hh          , Mm          , Mm          
