Ql^Ii, Ql^Ii, Ql^Ii, Xu, Xu, Xu, Uu, Ds, Ur^Fdw, Ur^Fdw, Ur^Dr, Ur, Ur, Ur, Ur, Ur, Wo, Wo, Ur, Hhd, Hhd, Xu, Xu, Xu, Xu, Xu, Xu, Xu, Xu, Xu, Xu, Xu
Xu, Ql^Ii, Xu, Ql^Ii, Xu, Qxu, Uu, Ds, Ur, Ur^Fdw, Ur, Ur, Cud, Ur, Cud, Ur, Wwf, Wo, Ur, Hhd^Fmw, Hhd^Fmw, Xu, Xu, Xu, Xu, Xu, Xu, Xu, Xu, Xu, Xu, Xu
Xu, Xu, Qxu, Xu, Xu, Ur, Qxu, Uu, Ur, Ur, Ur, Cud, Cud, 2 Kud, Cud, Cud, Ww, Uu^Vud, Ur, Hhd^Fmw, Ds, Xu, Ur, Xu, Hhd^Fmw, Xu, Xu, Xu, Xu, Xu, Xu, Xu
Qxu, Qxu, Uu^Fdw, Qxu, Qxu, Qxu^Bw|, Qxu^Bw/, Ur, Ur, Hhd, Hhd, Ur, Ur, Cud, Ur, Wwf, Ur, Wwf, Wo, Ur, Ur, Ur, Ur, Ur^Fmw, Ur^Fmw, Xu, Xu, Xu, Xu, Xu, Xu, Xu
Uu, Uu^Fdw, Ur, Uu, Ur, Ur, Qxu^Bw/, Qxu^Bw|, Uu, Hhd^Fdw, Ur, Ur, Ur, Ur, Ur, Ur, Dd^Dc, Ww, Wwf, Ww, Ur, Chw, Wwf, Ur, Ur, Uh, Xu, Uh, Hhd^Fdw, Xu, Xu, Xu
Uh, Ds, Ur, Ur, Uu^Vud, Uu^Fdw, Rp, Qxu, Ur, Ur, Uu, Uu, Uu, Ur, Ur^Fdw, Ur, Wwf, Wwf, Wwf, Ur, Wwf, Khw, Wwf, Uu^Vu, Ur, Uh, Ds, Uh, Uu^Vud, Ur, Ur, Xu
Ds^Fdw, Ds, Ur, Ur, Ur, Rp, Ur, Qxu^Bw/, Qxu^Bw/, Ur, Qxu, Qxu, Uu, Ur^Fdw, Ur, Uu^Vud, Ur, Ur, Ww, Wwf, Uh, Wwf, Wwf, Ur, Ur, Ur, Ur, Ur, Ur, Ur, Xu, Xu
Ur^Fdw, Ur^Fdw, Ur^Fdw, Ur, Ur, Ur, Uu^Tf, Re, Qxu^Bw|, Qxu^Bw|, Ur, Qxu^Bs/, Uu^Tf, Uu, Hhd, Ur, Ur, Ur, Ur^Fdw, Ur, Ur, Wwf, Wo, Wo, Ur^Fdw, Ur, Hhd, Ur, Ur, Ur, Ur^Fdw, Xu
Hhd, Hhd^Fdw, Ur, Ur, Ds, Ur, Ur, Re^Vct, Ur, Ur, Qxu^Bw\, Qxu, Uu^Fdw, Uu^Tf, Ur, Ur, Uu^Tf, Ur^Fdw, Hhd, Ur, Ur, Re^Vct, Wwf, Wwf, Ur, Hhd^Fdw, Ur, Ur, Khr, Ur, Ur, Xu
Uu, Ur, Ur, Ur, Uu^Tf, Uh, Ur, Ur, Uu, Uu, Qxu^Bw\, Re, Ur^Fmw, Ur, Ur, Ur, Qxu, Uu, Ur, Ur, Uu^Tf, Uu^Tfi, Wwf, Wwf, Wo, Wwf, Ww, Chw, Ur, Ur, Hhd, Uu
Uu, Uu^Vud, Wwf, Ur, Ur^Fdw, Ur^Fdw, Ur, Ur, Uu^Tf, Qxu, Uu, Re, Uu, Ur, Ur, Qxu^Bs\, Uu, Qxu^Bs/, Ur, Ur, Qxu, Wo, Xu, Wwf^Fdw, Rd^Fdw, Ur, Wwf, Chw, Ur, Hhd, Ur^Fmw, Hhd^Fmw
Uu, Uu, Ur, Wwf, Chw, Wwf, Ur, Ur, Uu, Qxu, Qxu, Qxu^Bw|, Qxu^Bs|, Qxu, Qxu^Bw|, Qxu^Bw\, Rd, Qxu^Bw/, Qxu, Qxu^Bw\, Rd, Qxu, Xu, Rd^Fdw, Ur^Fdw, Ur, Wwf, Ur, Wwf, Ur, Ur, Hhd^Fmw
Uu^Tf, Uh, Ur, Ww, Wwf, Ur, Hhd, Ur, Qxu^Bw\, Qxu^Bs\, Hhd, Rd, Uu, Uu, Rd, Uu, Rd, Uu, Uu^Dr, Uu, Uu^Fp, Qxu, Qxu, Xu, Uh, Ur, Ur, Ww, Wwf, Ur, Wwf, Ur
Wwf^Fmw, Ur^Fmw, Wwf, Wwf, Ur, Ur, Hhd^Fdw, Xu, Qxu, Rd, Rd, Chr, Rd^Fp, Rd, Hhd, Hhd^Fmw, Xu, Rd, Rd, Rd, Rd, Uh, Qxu, Xu, Xu, Ur^Fdw, Hhd, Ur, Wo, Wwf, Wwf^Fmw, Ww
Ww, Wwf^Fmw, Wwf, Wo, Ur, Hhd, Ur^Fdw, Xu, Xu, Qxu, Uh, Rd, Rd, Rd, Rd, Xu, Hhd^Fmw, Hhd, Rd, Rd^Fp, Chr, Rd, Rd, Qxu, Xu, Hhd^Fdw, Ur, Ur, Wwf, Wwf, Ur^Fdw, Wwf^Fmw
Ur, Wwf, Ur, Wwf, Ww, Ur, Ur, Uh, Xu, Qxu, Qxu, Uu^Fp, Uu, Uu^Dr, Uu, Rd, Uu, Rd, Uu, Uu, Rd, Hhd, Qxu^Bs\, Qxu^Bw\, Ur, Hhd, Ur, Wwf, Ww, Ur, Uh, Uu^Tf
Hhd^Fmw, Ur, Ur, Wwf, Ur, Wwf, Ur, Ur^Fdw, Rd^Fdw, Xu, Qxu, Rd, Qxu^Bw\, Qxu, Qxu^Bw/, Rd, Qxu^Bw\, Qxu^Bw|, Qxu, Qxu^Bs|, Qxu^Bw|, Qxu, Qxu, Uu, Ur, Ur, Wwf, Chw, Wwf, Ur, Uu, Uu
Hhd^Fmw, Ur^Fmw, Hhd, Ur, Chw, Wwf, Ur, Rd^Fdw, Wwf^Fdw, Xu, Wo, Qxu, Ur, Ur, Qxu^Bs/, Uu, Qxu^Bs\, Ur, Ur, Uu, Re, Uu, Qxu, Uu^Tf, Ur, Ur, Ur^Fdw, Ur^Fdw, Ur, Wwf, Uu^Vud, Uu
Uu, Hhd, Ur, Ur, Chw, Ww, Wwf, Wwf, Wwf, Wwf, Uu^Tfi, Uu^Tf, Ur, Ur, Uu, Qxu, Ur, Ur, Ur, Ur^Fmw, Re, Qxu^Bw\, Uu, Uu, Ur, Ur, Uh, Uu^Tf, Ur, Ur, Ur, Uu
Xu, Ur, Ur, Khr, Ur, Ur, Hhd^Fdw, Ur, Wwf, Wwf, Re^Vct, Ur, Ur, Hhd, Ur^Fdw, Uu^Tf, Ur, Ur, Uu^Tf, Ur^Fdw, Qxu, Qxu^Bw\, Ur, Ur, Re^Vct, Ur, Ur, Ds, Ur, Ur, Hhd^Fdw, Hhd
Xu, Ur^Fdw, Ur, Ur, Ur, Hhd, Ur, Ur^Fdw, Wo, Wo, Wwf, Ur, Ur, Ur^Fdw, Ur, Ur, Ur, Hhd, Uu, Uu^Tf, Qxu^Bs/, Ur, Qxu^Bw|, Qxu^Bw|, Re, Uu^Tf, Ur, Ur, Ur, Ur^Fdw, Ur^Fdw, Ur^Fdw
Xu, Xu, Uu^Vud, Ur, Ur, Ur, Ur, Ur, Ur, Wwf, Wwf, Uh, Wwf, Ww, Ur, Ur, Uu^Vud, Ur, Ur^Fdw, Uu, Qxu, Qxu, Ur, Qxu^Bw/, Qxu^Bw/, Ur, Rp, Ur, Ur, Ur, Ds, Ds^Fdw
Xu, Xu, Ur, Ur, Uh, Ds, Uh, Ur, Uu^Vu, Wwf, Khw, Ww, Ur, Wwf, Wwf, Wwf, Ur, Ur^Fdw, Ur, Uu, Uu, Uu, Ur, Ur, Qxu, Rp, Uu^Fdw, Uu^Vud, Ur, Ur, Ds, Uh
Xu, Xu, Xu, Hhd^Fdw, Uh, Xu, Uh, Ur, Ur, Wwf, Chw, Ur, Ww, Wwf, Ww, Dd^Dc, Ur, Ur, Ur, Ur, Ur, Ur, Hhd^Fdw, Uu, Qxu^Bw|, Qxu^Bw/, Ur, Ur, Uu, Ur, Uu^Fdw, Uu
Xu, Xu, Xu, Xu, Xu, Xu, Xu, Ur^Fmw, Ur^Fmw, Ur, Ur, Ur, Ur, Wo, Wwf, Ur, Wwf, Ur, Cud, Ur, Ur, Hhd, Hhd, Ur, Ur, Qxu^Bw/, Qxu^Bw|, Qxu, Qxu, Uu^Fdw, Qxu, Qxu
Xu, Xu, Xu, Xu, Xu, Xu, Xu, Hhd^Fmw, Xu, Ur, Xu, Ds, Hhd^Fmw, Ur, Uu^Vud, Ww, Cud, Cud, 1 Kud, Cud, Cud, Ur, Ur, Ur, Uu, Qxu, Ur, Xu, Xu, Qxu, Xu, Xu
Xu, Xu, Xu, Xu, Xu, Xu, Xu, Xu, Xu, Xu, Xu, Hhd^Fmw, Hhd^Fmw, Ur, Wo, Wwf, Ur, Cud, Ur, Cud, Ur, Ur, Ur^Fdw, Ur, Ds, Uu, Qxu, Xu, Ql^Ii, Xu, Ql^Ii, Xu
Xu, Xu, Xu, Xu, Xu, Xu, Xu, Xu, Xu, Xu, Xu, Hhd, Hhd, Ur, Wo, Wo, Ur, Ur, Ur, Ur, Ur, Ur^Dr, Ur^Fdw, Ur^Fdw, Ds, Uu, Xu, Xu, Xu, Ql^Ii, Ql^Ii, Ql^Ii
