border_size=1
usage=map

Gs^Fp       , Gs^Fds      , Gg          , Gg          , Gs          , Gg          , Hh^Fp       , Hh          , Cv          , Gg^Fet      , Ww          , Gg^Fet      , Cv          , Rp          , Gs^Fds      , Gs^Fms      , Gg          , Gg          , Gs          , Gs          , Gs          , Gs          , Gs          , Gg          , Gg          , Gg          , Gg          , Gg          , Gs          , Gg          , Gs          , Gs          
Gs^Fms      , Gs^Fp       , Gg          , Gs          , Gg          , Gs          , Gg          , Hh          , Gg          , Cv          , 1 Kv        , Cv          , Rp          , Rp          , Gll^Tf      , Gs^Fms      , Gg          , Gs          , Gs          , Gs^Efm      , Gs          , Gg          , Gg^Ve       , Gs          , Gll^Tf      , Gg^Efm      , Gs^Fds      , Gs          , Gg          , Gs          , Gg          , Gs          
Gs          , Gs^Fds      , Gs          , Gg^Efm      , Mm          , Gs          , Gs          , Gs          , Gs          , Cv          , Cv          , Cv          , Rp          , Gg          , Gs          , Gg          , Gg          , Gs          , Gs          , Gg          , Gs^Fms      , Gs^Fp       , Gs          , Gs          , Hh^Fms      , Mm          , Hh          , Gs          , Gs^Efm      , Gg          , Gs^Fp       , Gs^Fms      
Gg          , Gs          , Gs          , Gg          , Hh          , Hh^Fms      , Gs          , Gs          , Gg^Efm      , Gg          , Gg          , Rp          , Gg^Fet      , Gg          , Gs          , Gg^Ve       , Gs^Fds      , Gg          , Gs          , Gg          , Kv          , Cv          , Gs          , Gg          , Gg          , Gg          , Gs          , Gs          , Ww          , Ww          , Ww          , Ww          
Gg          , Gg          , Gs^Efm      , Gg          , Gs^Fp       , Gg^Ve       , Gs          , Gg          , Gs^Fms      , Gg          , Gg          , Rp          , Cv          , Gg          , Gs          , Gs^Efm      , Gs          , Gs          , Gg          , Hh          , Cv          , Cv          , Gs^Efm      , Gs          , Gs          , Gs          , Gg          , Ww          , Gg          , Gs^Fms      , Hh          , Hh          
Hh          , Gs          , Gg          , Gg          , Gs          , Gg          , Gs          , Gs          , Gg          , Hh          , Gs          , Rp          , Rp          , Gg          , Gg          , Gs          , Gg          , Gs          , Gg          , Gs          , Gs          , Gs          , Gs          , Gg          , Gg          , Gg^Ve       , Gg          , Wwf         , Gg          , Gg          , Gll^Tf      , Hh^Fds      
Cv          , Gg          , Cv          , Gg          , Gs          , Gs          , Gg          , Gg          , Gs          , Gs          , Gs          , Gg          , Rp          , Rp          , Rp          , Hh          , Gg^Fet      , Gg          , Ww^Ewf      , Gs          , Wwf         , Wwf         , Wwf         , Hh          , Hh^Fp       , Gs^Fms      , Wwf         , Wwf         , Gg          , Gs^Efm      , Gg          , Gg          
Cv          , Cv          , Kv          , Wwf         , Ww          , Gll^Tf      , Wwf         , Gg          , Gg          , Gg^Efm      , Ww          , Gg^Fet      , Rp          , Cv          , Rp          , Rp          , Wo^Bsb\     , Ww          , Ww          , Ww          , Gs          , Gg^Fet      , Wwf         , Ww          , Ww^Ewf      , Ww          , Ww          , Gg          , Hh^Fms      , Gs          , Gs          , Gs          
Gs^Fms      , Cv          , Gg^Efm      , Wwf         , Ww^Ewf      , Ww          , Hh          , Wwf         , Wwf         , Wwf         , Gg^Ve       , Ww          , Ww          , Rp          , Ww          , Ww          , Ww          , Wo^Bsb\     , Rp          , Hh          , Gs          , Gs          , Gg          , Ww          , Ww          , Ww          , Cv          , Cv          , Kv          , Gg          , Gs          , Gs          
Wwf         , Gg^Fet      , Wwf         , Wwf         , Ww          , Ww          , Gs^Fms      , Gs          , Gs          , Gs^Fp       , Gs          , Gs          , Gg          , Wo^Bsb|     , Gll^Tf      , Ww^Ewf      , Gs          , Gg^Fet      , Gs^Efm      , Rp          , Rp          , Gg^Ve       , Gs^Efm      , Gll^Tf      , Wwf         , Gg^Efm      , Gs          , Cv          , Gg^Fet      , Gs          , Gs          , Gg          
Gs^Fms      , Wwf         , Gs          , Gs          , Hh^Fds      , Ww          , Wwf         , Gs^Efm      , Gs          , Gg          , Gs          , Gs          , Gs          , Rp          , Gg          , Gs          , Gs          , Gs          , Gg          , Gg          , Rp          , Gs          , Gs          , Gs          , Wwf         , Gs          , Gs          , Gs          , Gs          , Gs          , Hh^Fds      , Hh          
Gs^Fms      , Gs^Fds      , Gs          , Gs          , Gg          , Gg^Ve       , Gs          , Wwf         , Gs          , Gs          , Gs          , Gg^Efm      , Rp          , Rp          , Gs^Fds      , Gs          , Hh          , Gs          , Gg          , Cv          , Rp          , Gg          , Hh^Fms      , Gs          , Wwf         , Mm          , Hh^Fp       , Gg          , Gg          , Gg^Ve       , Gg^Efm      , Hh^Fp       
Gs^Fp       , Gg          , Gg          , Gs^Efm      , Gg          , Gs          , Gs^Efm      , Wwf         , Wwf         , Gg          , Gs^Fms      , Gs          , Rp          , Cv          , Gs          , Gs          , Gg          , Gs          , Gs          , Rp          , Gs^Fp       , Gg          , Gs          , Wwf         , Gs          , Hh          , Gg          , Gg          , Gs          , Gs          , Gs          , Gg          
Gs^Fms      , Gll^Tf      , Gg          , Gs          , Gg          , Gg          , Gs^Fds      , Gg^Fet      , Wwf         , Mm          , Hh^Fp       , Gs          , Gg^Fet      , Rp          , Gs          , Gg          , Gg^Efm      , Gs          , Hh^Fds      , Rp          , Gg^Fet      , Gs^Efm      , Gs          , Wwf         , Gs          , Gs          , Gg          , Gg          , Gs^Fms      , Gg          , Hh          , Gg          
Ww          , Ww^Ewf      , Wo^Bsb|     , Ww          , Ww          , Wo^Bsb\     , Wo^Bsb\     , Wwf         , Ww^Ewf      , Ww          , Hh^Tf       , Wwf         , Rp          , Rp          , Rp          , Rp          , Rp          , Rp          , Rp          , Rp          , Wwf         , Wwf         , Ww          , Ww          , Gg          , Gs^Efm      , Ww          , Ww^Ewf      , Ww          , Wo^Bsb|     , Ww          , Ww          
Ww          , Ww          , Wo^Bsb|     , Ww          , Ww^Ewf      , Ww          , Gs^Efm      , Gg          , Ww          , Ww          , Wwf         , Wwf         , Rp          , Rp          , Rp          , Rp          , Rp          , Rp          , Rp          , Rp          , Wwf         , Hh^Tf       , Ww          , Ww^Ewf      , Wwf         , Wo^Bsb\     , Wo^Bsb\     , Ww          , Ww          , Wo^Bsb|     , Ww^Ewf      , Ww          
Gg          , Hh          , Gs          , Gs^Fp       , Gg          , Gg          , Gs          , Gs          , Wwf         , Gs          , Gs          , Gg^Fet      , Rp          , Hh^Fds      , Gg          , Gs          , Gs          , Gs          , Rp          , Gg^Fet      , Gg^Efm      , Hh^Fms      , Mm          , Wwf         , Gg^Fet      , Gs^Fds      , Gg          , Gg          , Gs          , Gg          , Gll^Tf      , Gs^Fds      
Gg          , Gg^Efm      , Gg          , Gs          , Gg          , Gg          , Hh          , Gg          , Wwf         , Gs          , Gg          , Gs^Fms      , Rp          , Gg          , Gg^Efm      , Gs          , Gs          , Gg          , Cv          , Rp          , Gs          , Gs^Fds      , Gs          , Wwf         , Wwf         , Gs          , Gs          , Gs          , Gs          , Gg^Efm      , Gg          , Gs^Fms      
Hh^Fp       , Gg          , Gg^Ve       , Gs          , Gs          , Hh^Fds      , Mm          , Wwf         , Gg^Efm      , Hh^Fms      , Gg          , Rp          , Cv          , Gs          , Gs          , Hh          , Gs          , Gs^Fp       , Rp          , Rp          , Gg          , Gs          , Gs          , Gs          , Wwf         , Gs^Efm      , Gg^Ve       , Gs          , Gs          , Gs          , Gs^Fp       , Gs^Fds      
Hh          , Hh^Fms      , Gs          , Gg          , Gg          , Gs^Efm      , Gs          , Wwf         , Gs          , Gs          , Gs          , Rp          , Gs          , Gg          , Gs          , Gs          , Gs          , Gs          , Rp          , Gg          , Gs^Efm      , Gs          , Gs          , Gg          , Gs          , Wwf         , Ww          , Hh^Fds      , Gg          , Gs          , Wwf         , Gs^Fms      
Gs          , Gs          , Gs          , Gg^Fet      , Cv          , Gs          , Gg          , Wwf         , Gll^Tf      , Gs          , Gg^Ve       , Rp          , Rp          , Gg          , Gg^Fet      , Gg          , Ww          , Gll^Tf      , Wo^Bsb|     , Gs          , Gs          , Gg          , Gs^Fms      , Gs          , Gs          , Gs^Fp       , Ww^Ewf      , Ww          , Wwf         , Wwf         , Gg^Fet      , Wwf         
Gs          , Gs          , Gg^Efm      , Kv          , Cv          , Cv          , Ww          , Ww          , Ww          , Gs          , Gg^Efm      , Gs          , Hh          , Rp          , Wo^Bsb\     , Ww          , Ww^Ewf      , Ww          , Rp          , Ww          , Ww          , Gg^Ve       , Wwf         , Wwf         , Wwf         , Hh          , Ww          , Ww          , Wwf         , Gg^Efm      , Cv          , Gs^Fds      
Gs          , Gg          , Gg          , Hh^Fp       , Gg          , Ww          , Ww          , Ww^Ewf      , Ww          , Wwf         , Gg^Fet      , Gs          , Ww          , Ww^Ewf      , Ww          , Wo^Bsb\     , Rp          , Rp          , Cv          , Rp          , Gg^Fet      , Ww          , Gg^Efm      , Gg          , Gg          , Wwf         , Gll^Tf      , Ww          , Wwf         , Kv          , Cv          , Cv          
Gg          , Gs          , Gs          , Gg          , Wwf         , Wwf         , Gs^Fms      , Hh^Fms      , Hh          , Wwf         , Wwf         , Wwf         , Gs          , Ww          , Gg          , Gg^Fet      , Hh          , Rp          , Rp          , Rp          , Gg          , Gg          , Gs          , Gs          , Gs          , Gg          , Gg          , Gg          , Gg          , Cv          , Gs          , Cv          
Hh^Fds      , Gll^Tf      , Gg          , Gs          , Wwf         , Gg^Efm      , Gg^Ve       , Gg          , Gg          , Gg          , Gg          , Gs          , Gs          , Gs          , Gs          , Gg          , Gs          , Gg          , Gg          , Rp          , Rp          , Gs          , Hh          , Gs          , Gs          , Gs          , Gs          , Gg          , Gg          , Gs          , Gs          , Hh          
Hh          , Hh          , Gs^Fds      , Gs          , Ww          , Gg          , Gs          , Gg          , Gs          , Gg          , Cv          , Cv          , Hh          , Gg^Efm      , Gs          , Gs          , Gg          , Gs          , Gg          , Cv          , Rp          , Gg^Efm      , Gg          , Gs^Fds      , Gg          , Gg          , Gg^Ve       , Gs^Fms      , Gg          , Gs^Efm      , Gs          , Gs          
Ww          , Ww          , Ww          , Ww          , Gs          , Gs          , Gs          , Gs          , Gs          , Gg          , Cv          , Kv          , Gg          , Gg          , Gg          , Gs^Fds      , Gg^Ve       , Gs^Efm      , Gg          , Gg^Fet      , Rp          , Gg          , Gg          , Gg          , Gs          , Gg          , Hh^Fp       , Hh          , Gg          , Gg          , Gg          , Gg          
Gs^Fds      , Gs^Fp       , Gg          , Gg          , Gg          , Hh          , Mm          , Hh^Fds      , Gg          , Gg          , Gs^Fds      , Gs^Fms      , Gg          , Gg          , Gs          , Gg          , Gg          , Gs          , Gs          , Rp          , Cv          , Cv          , Cv          , Gs          , Gs          , Gg^Efm      , Gg          , Mm          , Gg          , Gg          , Gs^Fp       , Gg          
Gs          , Gs          , Gs^Efm      , Gs          , Gg          , Gs^Fms      , Gs          , Gll^Tf      , Gg          , Gg^Ve       , Gs^Efm      , Gs          , Gs          , Gs          , Gg          , Gg          , Gs^Fms      , Gll^Tf      , Rp          , Rp          , Cv          , 2 Kv        , Cv          , Gs          , Hh          , Gg          , Gg          , Gs          , Gs^Efm      , Gs          , Gs^Fms      , Gs^Fds      
Gs          , Gs          , Gs          , Gs          , Gg          , Gg          , Gs          , Gs          , Gg          , Gs          , Gg          , Gs          , Gs          , Gs          , Gs          , Gs          , Gs^Fds      , Gs^Fp       , Rp          , Cv          , Gg^Fet      , Ww          , Gg^Fet      , Cv          , Hh          , Hh^Fds      , Gg          , Gs          , Gs          , Gs          , Gs^Fds      , Gs^Fds      
