border_size=1
usage=map

Mm^Xm       , Gg          , Mm^Xm       , Gg          , Mm^Xm       , Gg          , Mm^Xm       , Gg          , Mm^Xm       , Gg          , Mm^Xm       , Gg          , Mm^Xm       , Hh^Fp       , Hh^Fp       , Hh^Fp       , Ss          , Ss          , Ss          , Ss          , Hh^Fp       , Gg          , Mm^Xm       , Gg          , Mm^Xm       , Gg          , Mm^Xm       , Gg          , Mm^Xm       , Mm^Xm       , Mm^Xm       , Mm^Xm       , Mm^Xm       , Mm^Xm       , Mm^Xm       , Mm^Xm       
Mm^Xm       , Mm^Xm       , Mm^Xm       , Mm^Xm       , Mm^Xm       , Mm^Xm       , Hh^Fp       , Hh^Fp       , Gs^Fp       , Mm^Xm       , Hh^Fp       , Mm^Xm       , Gs^Fp       , Hh^Fp       , Gs^Fp       , Ss          , Ss          , Ss          , Ss          , Ss          , Hh^Fp       , Mm^Xm       , Mm^Xm       , Mm^Xm       , Mm^Xm       , Mm^Xm       , Mm^Xm       , Mm^Xm       , Mm^Xm       , Mm^Xm       , Mm^Xm       , Mm^Xm       , Mm^Xm       , Mm^Xm       , Mm^Xm       , Mm^Xm       
Mm^Xm       , Mm^Xm       , Mm^Xm       , Mm^Xm       , Mm^Xm       , Mm          , Gs^Fp       , Gs^Fp       , Re^Gvs      , Gs^Fp       , Gs^Fp       , Gs^Fp       , Rp          , Gs^Fp       , Re          , Ss          , Ss^Bw/      , Ss^Vm       , Ss          , Ss          , Gs^Fp       , Hh^Fp       , Gs^Fp       , Hh^Fp       , Hh^Fp       , Mm^Xm       , Mm^Xm       , Mm^Xm       , Mm^Xm       , Mm^Xm       , Mm^Xm       , Mm^Xm       , Mm^Xm       , Mm^Xm       , Mm^Xm       , Mm^Xm       
Mm^Xm       , Mm^Xm       , Mm^Xm       , Mm^Xm       , Mm          , Gs^Fp       , Gs^Fp       , Gg^Vh       , Re^Gvs      , Re^Gvs      , Rp          , Rp          , Chr         , Rp          , Rp          , Ss^Bw/      , Ss          , Ss          , Ss          , Ss          , Hh          , Hh          , Hh^Fp       , Ss          , Hh^Fp       , Mm^Xm       , Mm^Xm       , Mm^Xm       , Mm^Xm       , Mm^Xm       , Mm^Xm       , Mm^Xm       , Mm^Xm       , Mm^Xm       , Mm^Xm       , Mm^Xm       
Mm^Xm       , Mm^Xm       , Hh^Fp       , Mm^Xm       , Hh^Fp       , Gs^Fp       , Re^Gvs      , Re^Gvs      , Rp          , Rp          , Chr         , Chr         , Hh          , Chw         , Chw         , 2 Khw       , Wwf         , Ss          , Ss          , Ss          , Gg^Efm      , Gs^Fp       , Ss          , Ss          , Hh          , Mm          , Mm^Xm       , Mm^Xm       , Mm          , Mm^Xm       , Mm^Xm       , Mm^Xm       , Mm^Xm       , Mm^Xm       , Mm^Xm       , Mm^Xm       
Hh^Fp       , Hh^Fp       , Gs^Fp       , Mm          , Gg          , Hh^Fp       , Gg          , Gg          , Rp          , Chr         , Ww          , Ww          , Ww          , Gg^Efm      , Gs^Fp       , Wwf         , Wwf         , Wwf         , Wwf         , Ss          , Gg          , Gg^Efm      , Gg          , Gs^Fp       , Gs^Fp       , Hh^Fp       , Mm^Xm       , Mm^Xm       , Hh          , Gs^Fp       , Ss          , Mm^Xm       , Mm^Xm       , Mm^Xm       , Mm^Xm       , Mm^Xm       
Gs^Fp       , Gs^Fp       , Gg^Efm      , Gg          , Gg^Efm      , Gg          , Rp          , Rp          , Wwf         , Ww          , Wo          , Wo          , Wo          , Wwr         , Ww          , Wwf         , Ww          , Wwf         , Wwf         , Gg          , Gg^Vo       , Gg          , Gg^Efm      , Gg^Efm      , Hh          , Hh^Fp       , Hh^Fp       , Mm          , Re          , Gs^Fp       , Ss          , Hh          , Mm          , Mm^Xm       , Mm^Xm       , Mm^Xm       
Ss          , Gg          , Gg^Vo       , Gg          , Re          , Rp          , Hh          , Wwf         , Wwf         , Wo          , Wwr         , Xu          , Uu^Tf       , Wo          , Wo          , Wwf         , Wo          , Ww          , Ww          , Gg          , Gg          , Re          , Gg          , Gg^Es       , Co          , Ko          , Hh          , Re          , Gs^Fp       , Ss^Vhs      , Ss          , Re          , Hh          , Mm^Xm       , Mm^Xm       , Mm^Xm       
Gs^Fp       , Gg          , Gg          , Gg          , Rp          , Rp          , Gg          , Wwf         , Wwr         , Wo          , Xu          , Uh          , Xu          , Cud         , Uu^Tf       , Ur          , Uh          , Wo          , Wo          , Ww          , Ww          , Gg          , Gg          , Hh          , Rp          , Co          , Co          , Re          , Co          , Gs^Fp       , Hh          , Gs^Fp       , Gs^Fp       , Mm          , Hh          , Mm^Xm       
Chr         , Gg^Efm      , Rp          , Rp          , Hh          , Gg^Em       , Gg          , Ss^Vhs      , Wwf         , Ww          , Wo          , Xu          , Xu          , Xu          , Ur          , Uu^Tf       , Xu          , Wwf^Es      , Wwr         , Wo          , Ww          , Ww          , Gg          , Rd          , Rp          , Hh          , Re          , Co          , Gg          , Gg^Em       , Gg^Efm      , Hh          , Gg          , Hh^Fp       , Gs^Fp       , Mm          
Rp          , Rp          , Gg^Efm      , Re          , Re          , Gs^Fp       , Chr         , Gg          , Gg^Em       , Ww          , Ww          , Wo          , Wo          , Wwf         , Xu          , Xu          , Ww          , Uu^Tf       , Xu          , Wo          , Wo          , Ww          , Rp          , Rp          , Gg^Efm      , Gg^Efm      , Gg          , Hh          , Gg          , Hh          , Hh          , Gg          , Gg          , Hh^Vo       , Gs^Fp       , Hh^Fp       
Gs^Fp       , Chr         , Gg          , Gg          , Re          , Hh^Fp       , Gg          , Gg          , Gg          , Hh^Fp       , Gs^Fp       , Ww          , Ww          , Wwf         , Xu          , Ww          , Uu^Tf       , Uu^Es       , Xu          , Wo          , Wo^Bw/      , Ww^Bw/      , Wwf         , Gg          , Gg          , Gg          , Aa          , Gg          , Gg^Efm      , Gg          , Gs^Fp       , Hh^Fp       , Gg          , Gg          , Hh^Uf       , Gs^Fp       
Hh          , Gs^Fp       , Gg          , Gg^Efm      , Re          , Hh          , Gg          , Gg^Efm      , Gg^Efm      , Gg          , Gg^Em       , Hh          , Wwf         , Wwf         , Chw         , Chw         , Wo          , Ww          , Ww^Bw/      , Ww^Bw/      , Wwr         , Ww          , Wwf         , Ss^Vhs      , Gg          , Gg^Efm      , Ha^Fpa      , Gg          , Gg^Efm      , Gg          , Gg          , Hh          , Gg          , Gg^Efm      , Gg          , Hh          
Hh          , Hh          , Hh^Fp       , Gg          , Gg          , Re          , Hh^Uf       , Gg          , Gg          , Gg          , Gg^Vo       , Wwf         , Gg          , Gg^Efm      , Gll^Fp      , Wwf         , Ww^Bw/      , Wo^Bw/      , Rr          , Rr          , Aa^Fpa      , Wo          , Wwf         , Wwr         , Gg          , Gg^Efm      , Ms          , Aa          , Gg          , Gg^Efm      , Rd          , Gg          , Gg          , Gg^Efm      , Gg^Efm      , Gg          
Gg          , Rd          , Gg          , Hh^Vo       , Gg          , Re          , Mm^Xm       , Mm^Xm       , Gg          , Gg          , Re^Uf       , Hh          , Re^Gvs      , Gg^Em       , Rp          , Wwf         , Wwf         , Wwr         , Ha          , Cud         , Xu          , Uu^Tf       , Wo          , Wwf         , Wwf         , Gg^Efm      , Re^Uf       , Aa^Fpa      , Gg          , Gg          , Gg          , Gg^Vo       , Re          , Gg^Es       , Rp          , Rp          
Gg          , Gg^Efm      , Gg          , Gg          , Gg          , Re          , Gs^Fp       , Hh          , Gg          , Gg          , Re^Gvs      , Re^Gvs      , Re^Gvs      , Re^Gvs      , Rp          , Wwf         , Gs^Fp       , Wwf         , Wwf         , Ur          , Uu          , Xu          , Xu          , Ai          , Wwf         , Wwf         , Gg          , Gg          , Gg          , Gg          , Re          , Re          , Re^Gvs      , Re          , Rp          , Hh          
Hh          , Gg          , Gs^Fp       , Gg          , Gg          , Co          , Gg          , Gg          , Gg          , Gg          , Aa^Fpa      , Re^Gvs      , Gg^Wm       , Re^Gvs      , Rp          , Wwf         , Ww          , Wo          , Uu^Tf       , Uu          , Wwf         , Kud         , Uu^Tf       , Uu^Tf       , Ww          , Wwf         , Gg^Efm      , Gg          , Hh^Uf       , Hh          , Ha^Fpa      , Re^Gvs      , Re^Gvs      , Re^Gvs      , Rp          , Hh          
Mm          , Hh^Uf       , Rp          , Gg          , Gg^Efm      , Re          , Gg          , Gg^Efm      , Ha^Fpa      , Mm^Xm       , Ms          , Hh          , Hh^Uf       , Re^Gvs      , Rp          , Wwf         , Chw         , Uu^Tf       , Xu          , Kud         , Uu          , Uu          , Wwf         , Wo          , Ww          , Wwf         , Gg^Efm      , Hh^Fp       , Ha          , Mm^Xm       , Hh^Uf       , Dd^Dc       , Re^Gvs      , Re^Gvs      , Rp          , Mm          
Mm          , Co          , Rp          , Gg^Em       , Ds          , Re          , Gg^Efm      , Gg          , Rd          , Mm^Xm       , Ha          , Gs^Fp       , Re^Gvs      , Re^Gvs      , Rp          , Wwf         , Ww          , Wo          , Uu^Tf       , Xu          , Xu          , Ur^Es       , Wwf         , Wwf         , Wwf         , Wwf         , Gg          , Gg          , Gg          , Gs^Fp       , Gg          , Re          , Re          , Re^Gvs      , Rp          , Mm          
Mm          , Mm          , Hh          , Hh^Uf       , Re          , Re          , Gg          , Gg          , Gg          , Gg          , Gg          , Re^Gvs      , Re^Gvs      , Re^Gvs      , Gg          , Rp          , Ww^Bw\      , Ww          , Wwr         , Aa^Fpa      , Cud         , Ur          , Ww          , Gs^Fp       , Wwf         , Wwf         , Gg          , Gg          , Gg          , Gg          , Gg^Efm      , Gg          , Gs^Fp       , Re          , Rp          , Hh          
Hh          , Gs^Fp       , Gg          , Gg^Em       , Re          , Gg          , Gs^Fp       , Mm          , Co          , Gg^Efm      , Gg          , Gg          , Gg          , Gg          , Gg^Efm      , Wwf         , Ww          , Wo^Bw\      , Ww^Bw\      , Rr          , Rr          , Ha          , Wo          , Wwf         , Wwf         , Gg          , Gg^Efm      , Ms          , Ha          , Gg          , Gg          , Gg          , Gg          , Gg          , Rp          , Hh          
Ss          , Hh^Uf       , Gg          , Gg^Efm      , Re          , Ss          , Hh^Uf       , Mm^Xm       , Mm^Xm       , Gg          , Re          , Re^Uf       , Gs^Fp       , Gg          , Rr          , Gll^Fp      , Wwf         , Xu          , Wo          , Ww^Bw\      , Ww^Bw\      , Wwr         , Ww          , Wwf         , Ss^Vhs      , Gg          , Gg^Efm      , Aa^Fpa      , Aa          , Gg          , Gg^Vo       , Gg          , Gg          , Gg^Efm      , Gg^Efm      , Rp          
Ss          , Gg          , Gg          , Gg          , Re          , Gg          , Gg          , Hh          , Gg          , Gg          , Gg          , Gg^Vo       , Wwf         , Gg^Em       , Wwf         , Chw         , Chw         , Uu^Tf       , Wo          , Wwr         , Wo          , Wo^Bw\      , Ww^Bw\      , Wwf         , Gg          , Gg          , Gg^Efm      , Aa          , Gg          , Gg          , Gg          , Gg          , Gg          , Hh          , Rb^Uf       , Gg          
Hh          , Gg          , Hh^Fp       , Hh^Vo       , Re          , Gg^Efm      , Gg          , Gg^Efm      , Gg          , Gg          , Gg^Efm      , Gg          , Hh          , Wwf         , Ww          , Ww          , Wwr         , Xu          , Xu          , Wwf^Es      , Xu          , Wo          , Ww          , Wwf^Bw\     , Rp          , Gg^Efm      , Gg          , Ha^Fpa      , Gg          , Rd          , Gg^Efm      , Gg          , Hh          , Hh^Uf       , Gs^Fp       , Rb^Uf       
Gs^Fp       , Hh          , Hh          , Gg          , Re          , Gg          , Gg          , Hh          , Hh^Fp       , Gg          , Gg^Efm      , Gg          , Gs^Fp       , Wwf         , Wwf         , Wo          , Xu          , Xu          , Uh          , Uu^Tf       , Xu          , Xu          , Ww          , Wwf         , Gg          , Rp          , Rp          , Gg          , Gg          , Gg          , Gg          , Rp^Es       , Gs^Fp       , Mm^Xm       , Mm^Xm       , Hh          
Hh^Fp       , Gs^Fp       , Gg          , Gg          , Re          , Gg          , Hh          , Co          , Gg          , Gg          , Gg          , Gg          , Ww          , Ww          , Wo          , Wwf^Es      , Uu^Tf       , Cud         , Uu^Tf       , Wo          , Wo          , Wo          , Ww          , Gg          , Gg^Efm      , Rp          , Hh^Fp       , Hh          , Gg          , Gg^Efm      , Rp          , Chr         , Hh          , Mm          , Mm^Xm       , Hh^Fp       
Mm^Xm       , Hh^Fp       , Gg          , Gg          , Re          , Gs^Fp       , Hh          , Rd          , Gg          , Gg          , Ss^Vhs      , Wwf         , Ww          , Wo          , Uu^Tf       , Wwr         , Xu          , Ur^Es       , Wwf^Es      , Wo          , Ww          , Ww          , Re          , Gg          , Rp          , Rp          , Gg^Vo       , Gg          , Gg          , Gg          , Gs^Fp       , Gs^Fp       , Mm          , Mm^Xm       , Mm^Xm       , Mm^Xm       
Mm^Xm       , Hh          , Hh          , Gs^Fp       , Gg^Vh       , Re          , Re          , Gg          , Gg^Efm      , Gg          , Wwf         , Wwr         , Wo          , Wo          , Xu          , Xu          , Wo          , Wo          , Wwf         , Ww          , Gg          , Gg^Efm      , Gg          , Gs^Fp       , Rp          , Gg          , Gg          , Gg          , Gg^Efm      , Gs^Fp       , Hh^Fp       , Hh^Fp       , Mm          , Mm^Xm       , Mm^Xm       , Mm^Xm       
Mm^Xm       , Mm          , Hh          , Hh^Fp       , Gs^Fp       , Gg          , Re          , Gg          , Gg          , Gg          , Wwf         , Wwf         , Ww          , Wo          , Wo          , Wo          , Wo          , Ww          , Wwf         , Chw         , Chr         , Gg          , Gg          , Rp          , Re^Uf       , Gg^Em       , Hh          , Gg^Em       , Re          , Gs^Fp       , Gs^Fp       , Hh^Fp       , Mm          , Mm^Xm       , Mm^Xm       , Mm^Xm       
Mm^Xm       , Mm^Xm       , Mm          , Ss          , Hh^Fp       , Hh          , Co          , Hh          , Gg          , Gg          , Gg^Efm      , Wwf         , Wwf         , Ww          , Ww          , Ww          , Ww          , Ww          , Wwf         , Wwf         , 1 Khw       , Chr         , Chr         , Rp          , Chr         , Hh          , Hh^Es       , Re          , Re^Gvs      , Re^Gvs      , Gs^Fp       , Co          , Mm          , Mm^Xm       , Mm^Xm       , Mm^Xm       
Mm^Xm       , Mm^Xm       , Mm^Xm       , Hh          , Dd          , Gs^Fp       , Gs^Fp       , Co          , Co          , Gg          , Hh          , Gg          , Gg          , Gs^Fp       , Gs^Fp       , Wwf         , Wwf         , Wwf         , Wwf         , Wwf         , Ss          , Ss^Bw|      , Ss          , Chr         , Gg          , Gg^Efm      , Re          , Re^Gvs      , Gg^Vh       , Gs^Fp       , Hh^Fp       , Hh^Fp       , Mm          , Mm^Xm       , Mm^Xm       , Mm^Xm       
Mm^Xm       , Mm^Xm       , Mm^Xm       , Mm          , Hh          , Ss          , Ss          , Hh^Fp       , Gs^Fp       , Co          , Ko          , Hh          , Gg          , Gg          , Gg          , Gg          , Gg          , Wwf         , Ss          , Ss          , Ss          , Ss^Bw|      , Ss          , Ss          , Ss          , Gg          , Re          , Re^Gvs      , Re^Gvs      , Gs^Fp       , Gs^Fp       , Hh^Fp       , Mm          , Mm^Xm       , Mm^Xm       , Mm^Xm       
Mm^Xm       , Mm^Xm       , Mm^Xm       , Mm^Xm       , Mm^Xm       , Mm          , Mm          , Hh          , Ss^Vhs      , Hh^Fp       , Ss          , Co          , Re          , Gg^Efm      , Gg          , Gg^Vo       , Gg          , Gg          , Gg^Efm      , Ss          , Ss          , Ss^Vm       , Ss          , Ss          , Ss          , Gs^Fp       , Gs^Fp       , Gs^Fp       , Hh^Fp       , Re^Gvs      , Hh^Fp       , Hh^Fp       , Mm          , Mm^Xm       , Mm^Xm       , Mm^Xm       
Mm^Xm       , Mm^Xm       , Mm^Xm       , Mm^Xm       , Mm^Xm       , Mm^Xm       , Mm^Xm       , Hh          , Mm          , Hh          , Hh          , Hh          , Hh          , Re          , Re          , Gg          , Gg          , Gg          , Gs^Fp       , Gs^Fp       , Ss          , Ss          , Ss          , Gs^Fp       , Ss          , Ss          , Ss          , Gs^Fp       , Gs^Fp       , Hh^Fp       , Mm          , Mm          , Mm^Xm       , Mm^Xm       , Mm^Xm       , Mm^Xm       
Mm^Xm       , Mm^Xm       , Mm^Xm       , Mm^Xm       , Mm^Xm       , Mm^Xm       , Mm^Xm       , Mm^Xm       , Mm^Xm       , Mm^Xm       , Mm^Xm       , Mm          , Hh          , Hh          , Hh          , Re          , Hh          , Hh          , Hh          , Gs^Fp       , Gs^Fp       , Ss          , Ss          , Ss          , Ss          , Ss          , Ss          , Ss          , Gs^Fp       , Gs^Fp       , Mm          , Mm^Xm       , Mm          , Mm^Xm       , Mm^Xm       , Mm^Xm       
