Hh          , Hh          , Mm          , Gg          , Mm          , Mm          , Mm          , Mm          , Mm          , Gg          , Gg          , Gg          , Dd          , Ds          , Ss          , Ss          , Hh          , Mm          , Mm          , Hh          , Hh          , Hh          , Hh          
Hh          , Hh          , Mm          , Gs^Vh       , Gg          , Mm          , Gll^Fp      , Mm          , Mm          , Gll^Fp      , Gll^Fp      , Gll^Fp      , Gg          , Ds          , Ss          , Ss          , Mm          , Hh          , Gll^Fp      , Mm          , Hh          , Hh          , Gg          
Gg          , Gll^Fp      , Hh          , Gg          , Gg          , Gg          , Gg          , Hh          , Gll^Fp      , Mm          , Ch          , Ch          , Ch          , Dd          , Ss          , Ss^Vhs      , Ss          , Mm          , Gll^Fp      , Gll^Fp      , Ss          , Gll^Fp      , Ss          
Hh          , Hh          , Gg          , Gg          , Mm          , Gll^Fp      , Hh          , Gg          , Gg          , Gg          , Ch          , 1 Kh        , Ch          , Ss          , Ss          , Ss          , Ss          , Hh          , Mm          , Mm          , Ss          , Ss          , Ss          
Gg          , Gg^Ve       , Gll^Fp      , Gg          , Gg          , Mm          , Hh          , Gg          , Wwf         , Wwf         , Gg          , Ch          , Ss          , Ss          , Mm          , Gll^Fp      , Hh          , Hh          , Hh          , Ss          , Ss          , Ss^Vhs      , Dd          
Gll^Fp      , Gll^Fp      , Hh          , Gg          , Gg          , Gll^Fp      , Wwf         , Wwf         , Gg          , Gg          , Gg          , Rrc         , Ds          , Ds          , Gll^Fp      , Gll^Fp      , Hh          , Mm          , Mm          , Dd          , Dd          , Dd          , Wwf         
Hh          , Hh          , Mm          , Gg          , Wwf         , Wwf         , Gg          , Gg          , Gll^Fp      , Gg          , Gg          , Rrc         , Gg          , Gs^Vh       , Gg          , Gg          , Gll^Fp      , Gll^Fp      , Gg          , Wwf         , Wwf         , Wwf         , Mm          
Wwf         , Wwf         , Wwf         , Wwf         , Gll^Fp      , Gg          , Gll^Fp      , Hh          , Gll^Fp      , Gg          , Gg          , Rrc         , Gg          , Gg          , Gll^Fp      , Gg          , Gg          , Gg          , Gg^Ve       , Wwf         , Gll^Fp      , Mm          , Gg          
Gg          , Gg          , Rrc         , Gg^Ve       , Gg          , Gg          , Hh          , Xu          , Mm          , Gll^Fp      , Gs^Vh       , Rrc         , Hh          , Hh          , Hh          , Mm          , Gll^Fp      , Gg          , Wwf         , Wwf         , Gg          , Gll^Fp      , Gll^Fp      
Gg          , Gg          , Rrc         , Gg          , Gg          , Gg          , Hh          , Xu          , Xu          , Hh          , Gg          , Rrc         , Gll^Fp      , Mm          , Gll^Fp      , Mm          , Wwf         , Wwf         , Wwf         , Gg          , Gg          , Gg^Ve       , Gg          
Mm          , Mm          , Rrc         , Gg          , Gg          , Gg          , Xu          , Xu          , Gll^Fp      , Gll^Fp      , Gg          , Rrc         , Wwf         , Wwf         , Wwf         , Wwf         , Wwf         , Gg          , Gg          , Wwf         , Wwf         , Gg          , Gg          
Hh          , Hh          , Rrc         , Gg          , Gg          , Gll^Fp      , Mm          , Xu          , Hh          , Mm          , Gg          , Wwf         , Gg          , Gg          , Hh          , Mm          , Gll^Fp      , Hh          , Gg          , Gs^Vh       , Rrc         , Gg          , Hh          
Gg          , Gg          , Wwf         , Gs^Vh       , Gg          , Hh          , Wwf         , Gll^Fp      , Wwf         , Gg          , Wwf         , Wwf         , Gg          , Gll^Fp      , Mm          , Xu          , Xu          , Gll^Fp      , Gg          , Gg          , Rrc         , Hh          , Gg          
Gg          , Gg          , Gg          , Wwf         , Wwf         , Hh          , Wwf         , Wwf         , Mm          , Wwf         , Gll^Fp      , Rrc         , Gg          , Mm          , Xu          , Xu          , Hh          , Gg          , Gg          , Gg          , Rrc         , Gll^Fp      , Gg          
Mm          , Gs^Vh       , Gg          , Gg          , Wwf         , Wwf         , Mm          , Gll^Fp      , Hh          , Gll^Fp      , Hh          , Rrc         , Gs^Vh       , Hh          , Gll^Fp      , Xu          , Hh          , Gg          , Gg          , Gg          , Rrc         , Gg          , Gg          
Mm          , Mm          , Mm          , Wwf         , Gs^Vh       , Gg          , Hh          , Gll^Fp      , Gg          , Hh          , Gg          , Rrc         , Gll^Fp      , Mm          , Mm          , Xu          , Gll^Fp      , Gg          , Mm          , Gg^Ve       , Wwf         , Gg          , Wwf         
Gg          , Gll^Fp      , Wwf         , Wwf         , Gg          , Gg          , Gll^Fp      , Hh          , Gg          , Gg          , Gg          , Rrc         , Hh          , Hh          , Hh          , Gll^Fp      , Gg          , Gg          , Wwf         , Wwf         , Gll^Fp      , Wwf         , Hh          
Wwf         , Wwf         , Ds          , Wwf         , Gll^Fp      , Mm          , Hh          , Gll^Fp      , Mm          , Gg^Ve       , Ds          , Rrc         , Gg          , Gll^Fp      , Gg          , Gg          , Wwf         , Wwf         , Gg          , Gg          , Hh          , Hh          , Md          
Ds          , Ds          , Ss          , Ds          , Hh          , Gll^Fp      , Hh          , Mm          , Gll^Fp      , Ds          , Ss          , Rrc         , Gg          , Gg          , Wwf         , Wwf         , Hh          , Mm          , Gg          , Gg          , Md          , Md          , Hh          
Ss          , Ss          , Ss^Vhs      , Gg          , Gll^Fp      , Hh          , Gg          , Mm          , Ss          , Ss          , Ch          , Ch          , Ch          , Wwf         , Gg          , Gg          , Gs^Vh       , Gll^Fp      , Gll^Fp      , Gg          , Gg          , Gs^Vh       , Hh          
Ss          , Ss          , Ss          , Gll^Fp      , Mm          , Hh          , Ss          , Ss          , Ss          , Ss          , Ch          , 2 Kh        , Ch          , Gg          , Mm          , Gg          , Gg          , Hh          , Gg          , Gg          , Gg          , Hh          , Hh          
Hh          , Mm          , Hh          , Mm          , Mm          , Gll^Fp      , Gll^Fp      , Ss^Vhs      , Ss          , Gg          , Gg          , Ch          , Hh          , Gll^Fp      , Gll^Fp      , Hh          , Hh          , Gg          , Gg          , Gg          , Hh          , Gll^Fp      , Hh          
Hh          , Hh          , Gll^Fp      , Gll^Fp      , Hh          , Hh          , Ds          , Ss          , Ds          , Ds          , Gg          , Mm          , Gll^Fp      , Mm          , Hh          , Gll^Fp      , Gll^Fp      , Gll^Fp      , Gg          , Gg^Ve       , Gll^Fp      , Hh          , Hh          
Gg          , Hh          , Gg          , Gg          , Hh          , Hh          , Ds          , Ds          , Ds          , Ds          , Gg          , Mm          , Gg          , Mm          , Gg          , Gg          , Gg          , Gg          , Gg          , Gg          , Gg          , Hh          , Hh          
