Wot         , Wot         , Wo          , Xu          , Xu          , Xu          , Xu          , Xu          , Xu          , Xu          , Xu          , Xu          , Xu          , Xu          , Wot         , Xu          , Xu          , Xu          , Xu          , Xu          , Xu          , Xu          , Xu          , Xu          , Xu          , Xu          , Xu          , Xu          , Xu          , Xu          , Xu          
Xu          , Ww          , Ww          , Ss          , Ss          , Ss          , Ss          , Mm          , Mm          , Mm          , Hh          , Hh          , Gg          , Xu          , Wo          , Xu          , Hh^Fmw      , Xu          , Xu          , Xu          , Xu          , Xu          , Xu          , Xu          , Xu          , Xu          , Xu          , Xu          , Xu          , Xu          , Xu          
Rd          , Xu          , Xu          , Wwf         , Wwf         , Rr          , Rr          , Hh          , Gg          , Hh          , Gg          , Gg          , Wwf         , Wwf         , Wwf         , Gg          , Gs^Fp       , Gs^Fp       , Mm          , Xu          , Xu          , Xu          , Xu          , Xu          , Xu          , Xu          , Xu          , Xu          , Xu          , Xu          , Wot         
Ds          , Rd          , Ur          , Xu          , Xu          , Wwf         , Wwf         , Rr          , Wwf         , Wwf         , Wwf         , Wwf         , Sm          , Sm          , Sm          , Wwf         , Gg          , Gs^Fp       , Hh          , Mm          , Hh^Fmw      , Xu          , Mm          , Xu          , Xu          , Xu          , Xu          , Xu          , Wo          , Wot         , Ur          
Ds          , Rd          , Dd^Vdt      , Ur          , Ur          , Xu          , Wwf         , Wwf         , Gg          , Rr          , Rr          , Sm          , Gs          , Sm          , Sm          , Wwf         , Gg          , Gg          , Gg          , Hh          , Gs^Fp       , Hh          , Hh^Fmw      , Mm          , Gg          , Xu          , Ww          , Ww          , Xu          , Xu          , Xu          
Ds          , Dd^Dr       , Ds^Edp      , Ur          , Xu          , Wwf         , Gg          , Gg          , Gg          , Gg          , Ds          , Rr          , Rr          , Gs          , Gg          , Wwf         , Chw         , Chw         , 2 Khw       , Gg          , Gg          , Hh          , Hh          , Gg          , Wwf         , Wwf         , Xu          , Xu          , Xu          , Xu          , Xu          
Ss          , Ds^Edp      , Gd^Fetd     , Gd          , Xu          , Wwf         , Gg          , Gs^Fms      , Gg          , Ds          , Hh^Fds      , Mm          , Hh^Fds      , Rr          , Rr          , Gg          , Wwf         , Chw         , Chw         , Chw         , Gg          , Gg          , Wwf         , Wwf         , Gs^Fp       , Ds          , Ds          , Xu          , Xu          , Xu          , Xu          
Ss          , Gd          , Dd^Do       , Hd          , Xu          , Wwf         , Gs          , Gg          , Gg          , Hh          , Gg          , Gg          , Gg          , Gg          , Hh          , Rr          , Rr          , Wwf         , Hh^Fds      , Chw         , Wwf         , Wwf         , Gg          , Gg          , Rd          , Dd^Do       , Ds          , Xu          , Xu          , Xu          , Xu          
Ss          , Gd^Edpp     , Gd^Edp      , Ur          , Wwg         , Wwf         , Uu^Tfi      , Gs          , Gg          , Gg          , Gs^Vc       , Gg          , Gg          , Gg          , Mm          , Gg          , Gg          , Rr          , Rr          , Wwf         , Wwf         , Gg          , Gg^Ve       , Gg          , Gg          , Ds          , Gs          , Gs          , Xu          , Xu          , Xu          
Ss          , Ds^Edpp     , Gd          , Ss          , Xu          , Wwf         , Gs          , Gs^Fms      , Gg          , Gg          , Hh          , Gs^Fms      , Gg          , Gg          , Gg          , Gg          , Ds          , Ds          , Ds          , Rr          , Rr          , Wwf         , Gg          , Ss          , Ss          , Gg          , Gs          , Uu^Tfi      , Gs          , Xu          , Xu          
Ss          , Ds          , Ss^Bw|r     , Ss          , Xu          , Wwf         , Gg          , Gg          , Ds          , Gg          , Gg          , Gg          , Gg          , Ch          , Gg          , Ds          , Ds          , Dd^Do       , Ds          , Hh^Fds      , Rr          , Wwf         , Gg          , Gg          , Rd          , Ss          , Gg          , Gs          , Gg          , Xu          , Xu          
Ss          , Ss          , Uu^Tf       , Uu^Vu       , Ur          , Wwf         , Gg          , Ds          , Ds          , Rd          , Gg          , Gg          , Ch          , Kh          , Gg          , Ds          , Ds          , Ds          , Ds          , Rr          , Gg^Dr       , Wwf         , Gg          , Gg          , Rd          , Ss          , Ds          , Mm          , Mm          , Mm          , Hh          
Gg          , Ss          , Ur          , Uu          , Uh          , Wwf         , Gg^Emf      , Hh          , Hh^Fms      , Dd^Vda      , Gg          , Ch          , Gg          , Gg          , Gs^Fds      , Gg          , Gg          , Hh          , Rr          , Rr          , Gg          , Wwf         , Gg          , Ds          , Rd          , Ss          , Ds          , Ds          , Ds          , Hh          , Hh          
Gg          , Ur          , Gs          , Ur          , Gs          , Wwf         , Gg          , Gg          , Gs          , Gs          , Gs          , Gg          , Hh          , Gg          , Gg          , Hh          , Gs^Vh       , Gg          , Rr          , Gg          , Gg          , Wwf         , Ke          , Gg          , Gs^Fms      , Rd          , Rd          , Dd^Do       , Ds          , Hh          , Hh          
Wot         , Gs          , Wot         , Gs          , Gs          , Wwf         , Gg^Emf      , Gg^Emf      , Gg^Dr       , Uu^Tf       , Gs          , Gg          , Gs^Fds      , Gg          , Gg          , Gg          , Rr          , Rr          , Gg          , Gg          , Mm          , Wwf         , Ce          , Gg          , Gg          , Hh          , Gg          , Rd          , Dd^Vdt      , Ds          , Ds          
Ww^Ewf      , Wot         , Gg          , Ww          , Ww          , Wwf         , Gg          , Gg          , Gg          , Gs          , Gg          , Gg          , Gg          , Gg          , Gg          , Gg          , Rr          , Gg          , Gg          , Hh          , Gg^Ve       , Wwf         , Ce          , Ce          , Ce          , Gg          , Gg          , Ds          , Ds          , Ds          , Gg          
Ww^Ewf      , Ww^Ewf      , Ww^Ewf      , Gg          , Gg          , Wwf         , Wwf         , Gg          , Gg          , Gg          , Ce          , Gg          , Gg          , Gg          , Gg          , Hh^Fds      , Gg          , Ce          , Gg          , Gg          , Gs^Fds      , Wwf         , Wwf         , Gg          , Gg          , Gg          , Gg^Dr       , Gg          , Gg^Gvs      , Gg^Gvs      , Gg          
Ww^Ewf      , Ww^Ewf      , Ss          , Chs         , Ww^Ewl      , Gg          , Gg          , Ww          , Wwf         , Gg          , Gg          , Gg          , Ww          , Gg          , Gg          , Gg          , Gg          , Gg          , Gg          , Gg          , Gg          , Gg          , Gg          , Wwf         , Wwf         , Gg          , Gg          , Gg          , Gg^Gvs      , Gg^Gvs      , Ss          
Ss          , Ss          , Ss          , Ss          , Ss          , Ww^Ewl      , Gg          , Gg          , Gg          , Wwf         , Wwrg        , Ww^Bw\      , Gg          , Wwf         , Wwf         , Wwf         , Wwf         , Gg          , Gg          , Gg          , Wwrg        , Gg          , Gg          , Gg          , Gg          , Wwf         , Ss          , Ss^Vhs      , Ss          , Ss          , Ss          
Ss          , Ss          , Gg^Gvs      , Ss^Vhs      , Gg          , Wwf         , Wwf         , Gg          , Gg          , Gg          , Gg          , Gg          , Gg          , Gg          , Gg          , Wwf         , Gg          , Wwf         , Ww          , Ww^Bw\      , Gg          , Wwf         , Wwf         , Gg          , Gg          , Ww^Ewl      , Ww^Ewl      , Ss          , Ss          , Ss          , Ww^Ewf      
Gg          , Gg^Gvs      , Gg^Gvs      , Gg          , Gg^Dr       , Gg          , Gg          , Wwf         , Wwf         , Gg          , Gs^Fds      , Gg          , Gg          , Gg          , Gg          , Gg          , Gg          , Gg          , Gg          , Gg          , Ce          , Gg          , Gg          , Ww          , Wwf         , Gg          , Gg          , Chs         , Ww^Ewf      , Ww^Ewf      , Ww^Ewf      
Gg          , Gg^Gvs      , Ds          , Gg          , Gg          , Gg          , Ce          , Gg          , Ce          , Wwf         , Gg^Ve       , Gg          , Gg          , Ce          , Rr          , Hh^Fds      , Gg          , Gg          , Gg          , Gg          , Gg          , Gg          , Gg          , Gg          , Gg          , Wwf         , Ww          , Gg          , Gg          , Ww^Ewf      , Ww^Ewf      
Ds          , Ds          , Dd^Vdt      , Ds          , Gg          , Gg          , Gg          , Ce          , Ce          , Wwf         , Mm          , Hh          , Gg          , Gg          , Rr          , Gg          , Gg          , Gg          , Gs^Fds      , Gg          , Gs          , Gs          , Gg^Dr       , Gg          , Gg^Emf      , Wwf         , Gs          , Ww          , Wot         , Wot         , Wot         
Hh          , Ds          , Ds          , Rd          , Rd          , Hh          , Gs^Fms      , Gg          , Ke          , Wwf         , Gg          , Gg          , Rr          , Rr          , Gs^Vh       , Gg          , Gg          , Gg          , Hh          , Gg          , Gs          , Uu^Tf       , Gs          , Gg^Emf      , Gg          , Wwf         , Gs          , Gs          , Gs          , Gs          , Gg          
Hh          , Hh          , Ds          , Dd^Do       , Ds          , Rd          , Rd          , Gg          , Gg          , Wwf         , Gg          , Gg          , Rr          , Gg          , Gg          , Hh          , Gs^Fds      , Gg          , Gg          , Gg          , Gg          , Gs          , Hh^Fms      , Gg          , Gg^Emf      , Wwf         , Uh          , Ur          , Ur          , Ur          , Gg          
Hh          , Hh          , Mm          , Ds          , Ds          , Ss          , Rd          , Ds          , Gg          , Wwf         , Gg^Dr       , Rr          , Ds          , Hh          , Ds          , Gg          , Gg          , Gg          , Ch          , Ch          , Gg          , Dd^Vda      , Ds          , Hh          , Gg          , Wwf         , Ur          , Uu          , Uu^Tf       , Ss          , Ss          
Xu          , Mm          , Gg          , Mm          , Gg          , Ss          , Rd          , Gg          , Gg          , Wwf         , Rr          , Rr          , Ds          , Ds          , Ds          , Ds          , Gg          , Kh          , Gg          , Gg          , Gg          , Rd          , Ds          , Ds          , Gg          , Wwf         , Xu          , Uu^Vu       , Ss^Bw|r     , Ss          , Ss          
Xu          , Xu          , Gs          , Gs          , Gs          , Ss          , Ss          , Gg          , Gg          , Wwf         , Rr          , Hh^Fds      , Ds          , Dd^Do       , Ds          , Ds          , Gg          , Ch          , Gg          , Gg          , Hh          , Gg          , Gg          , Gg          , Gs          , Wwf         , Xu          , Ss          , Gd          , Ds          , Ss          
Xu          , Xu          , Xu          , Uu^Tfi      , Gs          , Gg          , Gg          , Ss          , Gg^Ve       , Wwf         , Wwf         , Rr          , Rr          , Ds          , Gg          , Gg          , Mm          , Gg          , Gg          , Gs^Fms      , Gs^Vc       , Gg          , Gg          , Gs^Fms      , Uu^Tfi      , Wwf         , Wwg         , Ss          , Gd^Edp      , Dd^Edpp     , Ss          
Xu          , Xu          , Xu          , Gs          , Ds          , Ds          , Rd          , Gg          , Gg          , Gg          , Wwf         , Wwf         , Hh^Fms      , Rr          , Rr          , Gg          , Hh          , Gg          , Gg          , Gg          , Gg          , Gg          , Gg          , Gs          , Gs          , Wwf         , Xu          , Ur          , Dd^Do       , Gd^Edpp     , Ss          
Xu          , Xu          , Xu          , Xu          , Ds          , Dd^Do       , Gs^Fp       , Gg          , Wwf         , Wwf         , Gg          , Chw         , Chw         , Wwf         , Wwf         , Rr          , Rr          , Gg          , Hh^Fds      , Gg          , Hh^Fds      , Hh          , Gg          , Gg          , Gg          , Wwf         , Xu          , Hd          , Gd^Fetd     , Gd          , Ss          
Xu          , Xu          , Xu          , Xu          , Xu          , Ds          , Wwf         , Wwf         , Hh          , Gg          , Gg          , Chw         , 1 Khw       , Chw         , Chw         , Gg          , Gg          , Rr          , Rr          , Mm          , Ds          , Ds          , Gg          , Gs^Fms      , Gg          , Wwf         , Xu          , Gd          , Ds^Edp      , Ds^Edp      , Ds          
Xu          , Xu          , Xu          , Xu          , Ww          , Wwf         , Gg          , Gg          , Hh^Fmw      , Hh          , Gs^Fp       , Gg          , Gg          , Chw         , Gg          , Wwf         , Sm          , Gs          , Gs          , Rr          , Rr          , Gg          , Gg          , Gg          , Wwf         , Wwf         , Ur          , Ur          , Dd^Vdt      , Ds^Dr       , Ds          
Ur          , Xu          , Wo          , Ww          , Xu          , Xu          , Xu          , Mm          , Mm          , Hh          , Hh^Fms      , Hh          , Hh          , Gg          , Gg          , Wwf         , Sm          , Sm          , Sm          , Sm          , Wwf         , Rr          , Wwf         , Wwf         , Wwf         , Xu          , Xu          , Ur          , Ur          , Rd          , Ds          
Wot         , Wot         , Xu          , Xu          , Xu          , Xu          , Xu          , Xu          , Xu          , Xu          , Xu          , Mm          , Mm          , Gs^Fp       , Gs^Fp       , Wwf         , Wwf         , Sm          , Wwf         , Wwf         , Gg          , Wwf         , Gg          , Rr          , Rr          , Wwf         , Wwf         , Xu          , Xu          , Rd          , Rd          
Xu          , Xu          , Xu          , Xu          , Xu          , Xu          , Xu          , Xu          , Xu          , Xu          , Xu          , Xu          , Xu          , Gs^Fp       , Hh^Fms      , Gg          , Wo          , Wwf         , Gg          , Gg          , Hh          , Hh          , Mm          , Hh          , Ss          , Rr          , Ss          , Wwf         , Ww          , Xu          , Xu          
Xu          , Xu          , Xu          , Xu          , Xu          , Xu          , Xu          , Xu          , Xu          , Xu          , Xu          , Xu          , Xu          , Xu          , Xu          , Xu          , Wot         , Xu          , Xu          , Hh          , Xu          , Mm          , Xu          , Mm          , Xu          , Ss          , Xu          , Ss          , Wo          , Ww          , Wot         
Xu          , Xu          , Xu          , Xu          , Xu          , Xu          , Xu          , Xu          , Xu          , Xu          , Xu          , Xu          , Xu          , Xu          , Xu          , Xu          , Wot         , Xu          , Xu          , Xu          , Xu          , Xu          , Xu          , Xu          , Xu          , Xu          , Xu          , Xu          , Xu          , Wot         , Xu          
