Gg, Gg, Gg, Gg, Gg, Gg, Gg, Gg, Rr, Gg, Gg, Gg^Gvs, Gg^Gvs, Gg^Gvs, Gg^Gvs, Gg, Gg, Gg, Gg, Gg, Gg^Eff, Gg^Gvs, Gg^Gvs, Gg^Gvs, Gg^Gvs, Gg^Gvs, Gg^Gvs, Gg^Gvs, Gg^Wm, Gg^Gvs, Gg^Eff, Gg, Ur, Gd^Fetd, Qlf, Qlf, Qlf, Uh, Gd^Fetd, Gg, Gg, Gg, Gg, Gg, Gg, Gg, Gg, Gg, Ww^Ewl, Ww^Ewl, Ww^Ewf
Gg, Gg, Gg, Gg, Gg, Gg, Gd^Fetd, Gg, Gg, Rr, Rrc, Gg^Gvs, Gg^Gvs, Gg^Gvs, Gg^Gvs, Gg^Gvs, Gg^Fet, Gg, Gg, Gg, Gg, Gg^Eff, Gg^Eff, Gg^Gvs, Gg^Gvs, Gg^Gvs, Gg^Gvs, Gg^Gvs, Gg^Eff, Gg^Eff, Uh^Emf, Uh, Uh, Uh, Ql^Bw\, Uh, Uh^Es, Uh^Es, Gg, Gg, Gg, Gg, Gg, Gg^Efm, Gg, Gg, Gg, Gg, Gg, Ww^Ewf, Gg
Gg, Gg, Hhd^Fdf, Hhd^Fdf, Gg, Gg, Gg, Gg, Gg, Gg^Efm, Chr, Rrc, Ch^Efm, Ch, Ch, Gg^Gvs, Ch, Ch, Ch^Es, Gg, Chr, Gg, Gg, Gg^Eff, Gg^Eff, Gg^Gvs, Gg^Eff, Gg^Eff, Uh, Uh^Dr, Ur, Xuc, Xuc, Qlf^Ii, Ql^Ii, Qlf^Bw\, Uh, Xuc, Gg, Gg^Efm, Gg, Gg, Gg^Es, Gg, Gg, Gg, Gg, Gg, Gg, Gg, Gg
Gg, Gg, Dd^Do, Mm^Xm, Hhd^Fdf, Gg, Gg, Gg, Gg, Gg, Rrc, Kh, Gg^Gvs, Gg^Gvs, Gg^Gvs, Kh, Gg, Gg, Gg, 2 Kh, Rrc, Gg, Gg, Gg, Gg, Gg^Eff, Gg, Gg, Xue, Ur, Uue^Br\, Uu^Emf, Qxe, Xuc, Xuc, Xuc, Kud, Uh, Gg, Gg, Gg, Mm^Xm, Mm^Xm, Gg, Gg^Emf, Gg, Mm^Xm, Mm, Gll^Es, Gg, Gg
Gg, Gg, Gg, Hhd^Vhhr, Gg^Es, Mm^Edpp, Gg, Gg, Rrc, Rrc, Gg, Gg, Gg, Gg^Efm, Gg, Rrc, Gg, Gg, Gg, Gg, Gg, Rrc, Rr, Gg, Gg^Efm, Gg, Gg, Gg^Es, Gg, Xue, Xuc, Qxu^Bs\, Uue^Br\, Urb^Ii, Urb^Ii, Urb^Ii, Ur, Uh, Gg, Gg, Mm, Mm^Xm, Mm^Xm, Mm^Xm, Uu^Uf, Mm^Xm, Mm^Xm, Hhd, Gll, Gg, Gg
Gg, Gg, Gg, Gg, Gg, Gg, Rr, Rr, Gg, Gg, Gg, Gg, Gg, Gg, Gg, Rrc, Hh^Fds, Gg, Gg, Gg, Gg, Gg, Gg, Rr, Rr, Gg, Gg, Gg, Gg, Gg, Xuc, Qxe, Xuc, Xuc, Xuc^Emf, Ur, Uu^Ufi, Gg^Es, Gg, Gg, Gg, Mm, Gg, Hhd^Fmf, Gg^Es, Mm^Xm, Mm^Xm, Mm^Xm, Gg^Es, Gg, Gg
Rr, Gg^Efm, Rr, Gg, Rr, Rr, Gg, Gg, Gg, Gg, Gg^Efm, Gg, Gg, Gg, Gg, Rrc, Gg^Efm, Hh, Gg, Gg, Gg, Gg, Ke, Gg, Gg, Rr, Rr, Gg, Gs^Fds, Gll^Fp, Gll^Fp, Xuc, Gg, Gg, Gg, Xue, Xue, Rp, Rp, Gg, Gg^Fet, Gg, Gg, Gg, Gg, Gg, Hhd, Mm^Xm, Gg, Gg, Gg
Gg, Rr, Gg, Rr, Mm^Xm, Gg, Gg, Ms, Hhd^Vhhr, Gg, Gg, Gg, Gg, Gg^Efm, Gs^Vl, Rrc, Gg, Gg, Gg^Efm, Gg, Gs^Vl, Gg^Es, Ket, Ket, Gg, Gg, Gg, Rrc, Rrc, Hh^Fds, Gg, Gg, Gg, Gs^Fds, Gg, Gg, Rp, Rp, Gg, Rp, Rp, Gg, Gg, Gg, Chr^Es, Gg, Gd^Vo, Gg, Gs^Ft, Gg, Gg
Gg, Gg, Gg, Gg, Gg, Gg, Gll, Ms, Gg, Gg, Hh^Fds, Gg, Gg, Gg, Gg, Rrc, Rrc, Gg^Es, Ww^Bw|r, Gs^Fms, Gg, Gg, Gg, Gg, Gg, Gg, Gg, Kv, Cv^Efm, Kv, Cv, Cv, Gg, Gg, Rrc, Rp, Gg, Gg, Gg, Gg, Aa, Rp, Rp, Gg, Gg, Gg, Gg, Gg, Dd^Do, Gg^Efm, Gg
Gg, Gg, Gg^Efm, Gg, Gg, Gll, Gd^Fetd, Gll, Gg, Gg, Gg, Gg, Gg, Gg, Gg, Gg, Rrc, Hh^Fms, Ss^Bw|r, Ss, Gg, Gg, Gg, Gg, Gg^Dr, Gg^Es, Gg, Gg, Gg, Gg, Gg, Rrc, Rrc, Rrc, Gg, Gg, Gg, Gg, Gg, Aa, Ms^Xm, Aa^Fda, Aa, Rp, Rp, Gg, Gg, Gs^Ft, Gg^Es, Gg, Gg
Gg, Gg, Gg, Gg, Gg, Gll, Gll, Gll, Gg, Gg, Gg, Gg, Mm, Gg, Gg, Gg, Rrc, Gs^Ft, Ww^Bw|r, Md, Gg, Gg, Gg, Gg^Wm, Gg^Eff, Gg^Eff, Gg^Eff, Gg, Gg, Gg^Ve, Gg, Rrc, Gg, Gg, Gg, Gg, Aa^Fpa, Gg, Aa^Fma, Ms, Ms, Mm^Xm, Mm^Xm, Aa^Fpa, Gg, Rp, Rp, Gg, Md, Md, Gg
Gg, Gg, Gg, Gg, Mm^Xm, Gg, Gg, Gg, Gg, Gg, Gg, Gg, Gg, Gg, Gs^Fms, Gg, Rrc, Gg^Fet, Wog^Bw|r, Gg, Gg, Gg, Gg^Eff, Gg, Gg^Gvs, Gg^Gvs, Gg^Gvs, Gg^Eff, Gg^Eff, Gg, Gg, Rrc, Gg, Gg, Gg, Gg, Gg, Aa^Vea, Ha, Ha, Gg^Es, Mm^Xm, Ha^Fda, Aa, Hh, Uu^Uf, Uu^Emf, Cdr, Rp, Md, Gg
Gg, Gg, Gg, Rd, Mm, Mm^Xm, Mm, Gg, Gg, Gg, Gs^Fds, Gg, Gg, Gg, Gg, Gg, Gg, Kud, Cud^Emf, Gg, Gg, Gg^Eff, Gg^Eff, Gg^Gvs, Gg^Gvs, Gg^Gvs, Gg^Eff, Gg^Eff, Gg, Gg, Gg, Rp, Ha^Fpa, Gg, Gg, Gg, Gg, Ha, Ha^Fpa, Aa, Gg, Mm^Xm, Ai, Hh, Hh^Fms, Hhd, Hd^Edpp, Hd^Edpp, Dd, Dd, Rp
Gg, Gg, Gg, Gg, Gg, Gg^Es, Wwrg, Gg, Gg, Gg, Gg, Gg, Gg, Hh, Hh^Fds, Gg, Gg, Cud, Gg, Gg, Gg, Gg, Gg, Gg^Eff, Gg^Eff, Gg^Eff, Gg, Chr^Emf, Gg, Gg, Gg, Rp, Gg, Gg, Gg, Gg, Gg, Gg, Gg, Gg, Ai, Ai, Wwg^Bw\r, Ai, Gg, Gg, Hhd, Dd^Esd, Ds, Dd^Esd, Gg
Gg, Gg, Gg, Gg, Wwg, Sm^Es, Chs, Gg, Gg, Gg, Gg, Gg, Gg, Gg, Ww^Ewl, Gg, Gg, Gg, Md^Xm, Mm^Efm, Gg, Gg, Gg, Gll^Fp, Gg, Gg, Gg, Gg, Gg, Gg, Gg, Rrc, Gs, Gg, Gg, Gd^Fdf, Gd^Fetd, Gg, Gg, Gg, Ai, Wo, Ai, Ai, Gg, Gg, Gs^Ft, Ds, Dd^Vdt, Hd, Gg
Gg, Gg, Gg, Sm^Bw|r, Gg, Ss, Wwg, Gg, Wwf, Gg, Gg, Gs^Ft, Wwg, Wwg^Bw|r, Gg, Gg, Mm^Gvs, Md^Xm, Xuce, Xuce, Urb, Gg, Gg, Hhd^Fmf, Gg, Gg, Gg, Gd^Fetd, Gg, Gg, Gg, Rp, Gg, Gd, Gg, Gg, Gg, Gg, Aa, Gg, Ai, Wwg, Ai, Gg, Gg, Gg, Dd, Dd^Dc, Hd, Hd, Gg
Gg, Gg, Gg, Gg^Dr, Gg, Gg, Gg, Gg, Gg, Wwf^Bw/r, Wwf, Wwg, Ww, Gg, Gg, Gg, Gg, Xuce, Qxua, Uu^Vu, Urb, Urb, Uu, Gg, Gg, Gg, Gg, Gg, Gg, Gg, Ms^Xm, Gg, Gg, Gg, Ha^Fma, Gg, Gg, Gg, Aa, Aa, Ai, Wwg, Aa, Gg, Gg, Gg, Dd, Dd^Do, Rd^Edp, Dd^Dc, Gg
Gg, Gg, Gg, Gg, Gg, Gg, Gg, Gg, Aa^Fma, Gg, Ss, Gg, Gg, Gg, Gg, Gg, Gg, Xue, Urb, Qxu^Bs/, Qxua, Uh^Ii, Gg, Gg, Gg, Gg, Hh^Fp, Cv, Gg, Gg, Ha^Fma, Ms^Xm, Gg, Gg, Aa^Fda, Gg, Aa, Aa^Bw\r, Aa^Fda, Ai, Aa^Fda, Aa, Gg, Gg, Gg, Gg, Gg, Ds^Esd, Ds, Rd^Esd, Gg
Gg, Gg, Khs, Gg, Gg, Ss^Vhs, Gg, Gg, Hhd^Fdw, Ms^Xm, Wwf, Gg, Gll, Gll, Gll, Gg, Gg, Uh, Urb, Hhd^Fdw, Xu, Uu^Ufi, Gg, Gg, Gg, Gs^Fms, Md, Gg, Gg, Gg, Gg, Gg, Gg, Ww^Vm, Ww, Aa, Ds, Ds, Ai^Bw|r, Ai, Gg, Gg, Gg, Gg, Gg, Gg, Gg, Ww^Ewl, Wwg^Bw|, Gg, Gg
Gg, Gg, Gg, Ss, Wwg, Ww^Ewf, Gg, Gg, Uu^Uf, Ms^Xm, Wwf, Gg, Md, Gd^Fdf, Hhd^Fdf, Gg, Gg, Uh, Urb, Uu^Uf, Mm, Mm, Md^Xm, Gg, Gg, Gg, Gs^Fds, Hh^Fp, Gg, Gg, Gg, Rp, Gg, Aa, Aa, Aa, Ai, Ai, Gg, Ha^Fpa, Gg, Gg, Gg, Cha, Gg, Gg, Gg, Wwg, Ww^Vm, Gg, Gg
Gg, Gg, Sm, Re^Es, Wwf, Gg, Gg, Gg, Chs, Aa, Gg, Gg, Gg, Hhd^Fmf, Khr, Gg, Gg, Gg, Md, Hhd^Fmf, Gll, Mm, Mm, Gg, Gg, Gg, Gg, Hhd^Fdw, Aa^Fma, Aa, Aa, Rp, Ai, Ai, Ai, Aa, Gg, Gg, Gg, Gg^Es, Gg, Gg, Gg, Gg, Gg, Gg, Gg, Ww^Ewf, Wwg^Bw|, Ss, Gg
Gg, Gg, Sm, Wwg, Wwf^Bw/r, Gg, Gg, Gg, Wwf, Gg, Gg, Gg, Gg, Gg, Gg, Gg, Gg, Gg, Gg^Es, Gll, Gg, Gg, Gg, Gg, Gg, Gg, Gg, Gg, Ha^Fpa, Cha, Ai, Ai, Wog, Ai, Ai, Aa, Ha^Fda, Gg, Gg, Gg, Gg, Gg, Gg, Gg, Gg, Gg, Gg, Gg, Gg, Chs^Emf, Gg
Gg, Gg, Gg, Wwg^Bw/r, Wwrg, Ww^Ewl, Wwf, Gg, Wog, Wwf, Wwf, Ww^Vm, Gg, Gg, Gg, Gg, Gg, Gg, Gg, Gg, Gg, Gg, Cea, Gg, Gg, Gg, Aa, Gg, Aa, Aa, Ai, Wo^Bw\r, Wo^Bw\r, Wog, Wo, Ai, Aa, Ha^Fma, Gg, Gg, Gg, Hhd^Fdw, Gd^Fdf, Gg, Gg, Ms^Xm, Ms, Gg, Gg, Gg, Gg
Gg, Gg, Rb, Gg, Gs^Ft, Wwf, Re^Es, Wog, Sm, Wo, Wwrg, Wwr, Rp, Gg, Gg, Hh, Gg^Efm, Gg, Aa^Fda, Gg, Gg, Gg, Gg, Gg, Ds, Ds, Ai, Aa, Ww^Vm, Ai, Ai, Wo, Ai, Coa, Wo^Bw\r, Ai, Aa, Gg, Gg, Gg, Gg, Hhd^Fdf, Hhd^Fmf, Gg, Ha^Fpa, Ms^Xm, Gg, Gg, Gg, Gg, Gg
Gg, Gg, Ss, Ss, Ss, Re^Em, Wo, Wog, Ww^Ewl, Chs, Ww^Ewf, Wwf, Ds, Gg, Gg, Gg, Hh^Fp, Hh^Fp, Mm^Xm, Hh^Fp, Aa, Gg, Ds, Ds, Aa^Bsb\, Ai, Ai, Aa, Gg, Aa, Ai, Wog, Ai, Ai, Ai, Ai, Aa, Gg, Ms, Gg, Gg, Gg, Gg, Gg, Gg, Gg, Gg, Gg, Gg, Gg, Gg
Gg, Gg, Ss, Chs, Gs^Ft, Wwf, Wwf, Wwrg, Wwf, Wot, Wwf, Ds, Ds, Gg, Gg^Es, Aa^Fpa, Ha^Fpa, Mm^Xm, Ms^Xm, Hh^Fp, Aa^Fpa, Hh, Ai, Ai, Ai, Rr, Aa, Aa, Gg, Gg, Aa, Wog, Ai, Ai, Ai, Aa, Ww^Vm, Aa, Gg, Gg, Gg, Gg, Gg, Gg, Gg, Gg, Gg, Hhd^Fdw, Gg, Gg, Gg
Gg, Gg, Gg, Ss, Ds, Wwf, Wwf, Wwrg, Wwf, Khw^Emf, Wwf, Wwrg^Efm, Gg, Gg, Hh^Fp, Hh^Fp, Ha, Mv, Ms^Xm, Ha^Fpa, Ai, Aa, Ds, Ai, Rr, Rr, Aa^Fda, Aa, Gg, Gg, Gg, Ai, Gg, Aa, Aa, Aa, Rp, Aa, Gg, Gg, Aa^Fda, Gg, Gg, Gg, Gg, Gg, Gg, Gg, Gg, Gg, Rp
Gg, Gg, Gg, Gg, Hh^Fds, Ds, Gg, Ww^Vm, Wwf, Wwf, Wwf, Wwf, Gg, Gg, Mm^Xm, Hh^Es, Hhd^Vhhr, Mm^Xm, Ha, Ha^Fpa, Ai, Ds, Rr, Rr, Cea, Gg, Gg, Gg, Gg, Gg, Gg, Gg, Ha, Gg, Gg, Gg, Rp, Gg, Gg, Gg, Aa, Gg, Gg, Gg, Gg, Hhd^Fmf, Gg, Gg, Rp, Rp, Gg
Gg, Gg, Gg, Gg, Hh^Fms, Hh^Fds, Gg, Wwr, Wwrg, Ds, Gs^Ft, Gs^Ft, Gg, Gg, Gg, Hh^Em, Hh^Fp, Hh^Fp, Ai, Ai, Rr, Rr, Gg, Gg, Gg, Gg, Gg, Gg, Gg, Gg, Aa^Fma, Gg, Gg, Gg, Gg, Gg, Rp, Gg, Aa, Ha^Fpa, Ha, Ms, Ha, Gg, Gg, Gg, Rp, Rp, Gg, Gd^Fdf, Gg
Gg, Gg, Gg, Gg, Hh^Fds, Gg^Fet, Gg, Gg, Gg, Gg, Gg, Gg^Efm, Gg, Gg, Gg, Gg, Gg, Gg, Aa^Bw/r, Cha, Gg, Gg, Gg, Gg, Gg, Gg, Gg, Gg, Gg, Gs, Ke, Gg, Hhd^Fmw, Gg, Gg, Rp, Gg, Aa, Ms^Xm, Mm^Xm, Ms^Xm, Ms, Aa, Ha^Fpa, Gg, Gg, Rp, Gs^Fds, Gg, Gg, Gg
Gg, Gg, Gg, Hhd^Fmf, Hhd^Fmw, Mm^Wm, Gg, Gg, Gg, Chr, Gg, Gg, Gg, Chr, Gg, Gg, Rr, Cha, Aa, Gg, Gg, Gg, Gg^Efm, Gg, Gg, Gg, Mm^Xm, Gg, Hhd^Fmw, Ce, Ce, Gs, Gg, Gg, Gg, Rp, Gg, Ms, Ms, Ms^Xm, Ha, Aa, Gg, Gg, Rp, Rp, Gg, Gg, Rd, Rd, Gg
Gg, Gg^Efm, Gg, Hhd^Fdf, Hhd^Fdw, Hhd^Fmf, Gg, Gg, Gg, Gg, Gg, Gg, Gg, Gg, Gg, Wwf, Rr, Gg, Ha^Fda, Aa^Es, Gg, Gg, Gs^Fds, Hh^Fds, Gg, Gg, Mm^Xm, Re, Re, Gg, Gg, Gg, Gg, Gg, Rp, Rp, Mm^Xm, Ha^Fda, Gg, Ha, Aa^Voa, Gg, Gg, Rp, Gg, Gg, Ds, Rd, Hd, Hd^Edpp, Gg
Gg, Gg, Gg, Hhd^Fdw, Mm, Gg, Gg, Gs^Fms, Gg, Gg, Gg, Gg, Gs^Fms, Mm, Gg, Wwf, Rr, Chr, Aa^Fma, Aa, Gg, Gg, Gg, Gg, Gg, Gg, Re, Ss, Ss, Gg, Gg, Gg, Gg, Hh^Fds, Rp, Gg, Gg, Gg, Gg, Gg, Gg, Gg, Gg, Rp, Gg, Ds, Cdr^Edpp, Hd^Edp, Dd^Dc, Md^Xm, Gg
Gg, Gg, Gg, Mm^Xm, Mm^Xm, Mm^Xm, Mm^Xm, Gg, Gg, Gg, Gg, Gg, Gg, Gg, Gg, Gg, Chr, Cha, Ch, Gg, Gg, Gg, Gd^Vo, Gg, Gg^Fet, Gg, Gg, Chs, Gg, Gg, Gg, Gg, Co, Co, Gg, Gg, Gg^Efm, Gg, Gg, Gg, Gg, Gg, Rp, Rp, Rp, Rd, Rd, Dd^Do, Hd^Edpp, Hd^Esd, Gg
Gg, Gg, Gg^Es, Mm, Mm^Xm, Mm^Xm, Mm^Xm, Gg, Gg, Gg, Gg, Gg, Gg^Efm, Gg, Gg, Gg, Aa^Fpa, Aa^Fma, Gg, Kha, Rr, Gg, Gg, Gg, Gg, Gg, Gg, Gg, Gg, Gg, Gg, Gg, Gg, Ko, Gg, Gg, Gg, Gg, Gg, Gg, Rp, Rp, Gg, Gg, Gg, Rp, Rp, Rd, Rd, Rd, Gg
Gg, Gg, Gg, Mm, Mm, Mm^Xm, Hhd^Fdf, Mm^Xm, Uu^Uf, Gg, Gg, Gg, Gg, Gg, Gg, Gg, Gg, Gg, Gg, Gg, Ms, Rr, Gg, Gg, Gg, Gg, Gg, Gg, Gg, Gg, Gg, Gg, Gg, Rp, Rp, Gg, Gg, Gg, Gg, Rp, Gg, Gg, Gg^Efm, Gg, Gg, Gg, Gg, Rp, Rp, Gg, Gg
Gg, Gg, Hhd, Hhd, Hhd^Fdf, Md, Gg, Gg, Mm^Xm, Mm^Xm, Mm^Xm, Mm, Mm, Gg, Gg, Gg, Gg, Gg, Gg, Gg, Gll^Fp, Rr, Rr, Gg, Md^Xm, Md^Xm, Hh^Fds, Gg, Gg, Hh, Hh, Gg, Hhd, Hhd, Rp, Gg, Gg, Gg, Gg^Efm, Rp, Gg, Gs^Ft, Dd^Do, Gg, Md^Edp, Md^Xm, Gg, Gg, Gg, Rp, Rp
Gg, Gg, Gg, Gg, Gg, Gg, Gg, Hhd, Mm, Mm^Xm, Mm^Xm, Mm^Xm, Mm^Xm, Mm, Gg, Gg, Gg, Gg, Gg, Gg, Gg, Gg, Gg, Rr, Rr, Gll^Fp, Gg, Gg, Gg, Gg, Gg, Gg, Gg, Gg, Rp, Gg, Gg, Gg, Gg, Rp, Gg, Dd^Vda, Hhd, Dd^Edpp, Hh, Md, Gg, Gg, Dd^Do, Gg, Gg
Gg, Hhd^Fmw, Gg, Gg, Coa^Em, Gg, Gg, Gg, Mm, Mm^Xm, Mm^Xm, Mm^Xm, Mm^Xm, Mm^Xm, Mm^Xm, Gg, Gg, Gg, Gg, Gg, Gg^Efm, Gg, Gg, Gg, Gg, Rr, Rrc, Gg^Efm, Rrc, Gg, Rp^Vhcr, Gg, Gg, Gg, Rp, Gg, Gg, Gg, Rp, Rp, Gg, Hhd, Dd^Do, Gs^Ft, Gg^Efm, Gg, Gg, Gg, Gs^Ft, Gs^Ft, Gg
Gg, Gg, Gg, Gg, Gg, Gg, Gg, Gg, Gg, Mm, Mm, Mm^Xm, Mm^Xm, Mm^Xm, Gg, Gg, Gg, Hh, Gg, Gg, Gg, Gg, Gg, Gg, Gg, Gg, Gg, Rrc, Gg, Rrc, Rrc, Gg, Gg, Gg, Rp, Gg, Rr, Rr, Gg, Gg, Gg, Rd, Rd, Gs^Ft, Dd^Edp, Md, Gg, Gg, Gg, Gg, Gg
Gg, Gg, Gg, Gg, Gg, Gg, Gg, Gg, Hhd^Fdf, Gg, Gg, Mm, Gg, Gg^Es, Gg, Gg, Gg, Gg, Gg, Gg, Gd^Fetd, Gg, Cud^Emf, Gg, Gg^Efm, Gg, Hhd^Fmw, Gg, Gg, Gg, Ko, Gg, Gg, Gg, Ko^Es, Rr, Gg, Gg, Gg, Gg, Gg, Gg, Gg, Rd, Md^Edp, Md^Edp, Md, Gg^Eff, Gg^Eff, Gg, Gg
Gg, Gg, Gg, Ms^Xm, Ms^Xm, Ms^Xm, Ms^Xm, Gg, Gg, Hhd^Fdf, Gg, Gg, Gg, Gg, Gg, Gg, Gg, Gg, Gg, Gg, Gg, Gg, Gg, Gg, Gg, Gg, Uu^Uf, Rp^Vhcr, Gg, Gg, Co, Gg, Gg, Gg, Co^Em, Gg, Gg, Gg, Uu^Uf, Gg, Gg, Gg, Gg, Rd^Edp, Rd, Dd^Dc, Hd^Es, Dd^Es, Dd^Esd, Gg^Eff, Gg^Eff
Gg, Gg, Gg, Ms^Xm, Qlf, Qlf, Qlf, Ms^Xm, Cea^Em, Gg, Gg, Gg, Gg, Gg^Efm, Gg, Gg, Gg, Gg, Gg, Gg, Gg, Gg, Gg, Gg, Gg, Gg, Gg, Gg, Gg, Co, Gg, Co, 1 Ko, Co, Gg, Co^Es, Gg, Gg, Gg, Gg, Gg, Gg, Gg, Dd^Vda, Rd, Dd^Do, Rd, Ds^Edpp, Dd, Dd, Gg
Gg, Gg, Ai, Ms^Xm, Aa^Fda, Ql, Ms^Xm, Ms^Xm, Ha^Fda, Gg, Gg, Gg, Gg, Gg, Gg, Gg, Ce, Hh^Fds, Hh^Fds, Mm^Xm, Hh^Fds, Gg, Gg, Chr, Chr^Emf, Gg, Gg, Gd^Fetd, Gg, Gg, Gg, Gg, Co, Gg, Gg, Gg, Gg, Gg, Gg, Gg, Gg, Gg, Gg, Hd, Rd, Rd^Edpp, Cdr^Edp, Dd, Hd^Edpp, Hd^Edp, Gg
Gg, Ms^Xm, Ms^Xm, Aa, Aa, Ms^Xm, Gg^Es, Ms^Xm, Gg, Gg, Gg, Gg, Gg, Gg, Gg^Efm, Gg, Gg, Hh^Fds, Hh^Fp, Hh^Es, Hh^Fds, Gg, Gg, Khr, Gg, Gg, Gg^Eff, Gg^Eff, Gg^Eff, Gg, Gg, Gg, Gg, Gg, Gg, Gg, Gg^Efm, Gg, Gg, Gd^Fmw, Hhd^Fdw, Gg, Gg, Rd^Edpp, Rd^Edpp, Kdr^Edpp, Dd, Dd, Dd, Hd, Gg
Gg, Ha^Fda, Ms^Xm, Gg, Gg, Gg, Gg, Gg, Gg, Gg, Hh, Gg, Gg, Gg, Gg, Gg, Aa, Mm^Xm, Mm^Xm, Hh^Fp, Gg, Gg, Gg, Gg, Gg^Eff, Gg^Eff, Gg^Gvs, Gg^Wm, Gg^Gvs, Gg^Eff, Gg^Eff, Gg, Gg, Gg, Gg, Gg, Gg, Gg, Gg, Hhd^Fdw, Gg, Gg, Gg, Gg, Gg, Rd, Dd, Dd^Edp, Md^Edp, Dd, Gg
Gg, Gg, Gg, Gg, Gg, Gg, Gg, Gg, Hh, Hh^Es, Hh, Hh^Es, Hh, Gg, Gg, Aa, Aa, Aa, Aa, Ms, Gg, Gg, Gg^Eff, Gg^Eff, Gg^Gvs, Gg^Gvs, Gg^Gvs, Gg^Gvs, Gg^Gvs, Gg^Gvs, Gg^Gvs, Gg^Eff, Gg^Eff, Gg, Gg, Gg, Gg, Gg, Gg, Gg, Gg, Gg, Gg, Gg, Gg, Gg, Dd, Dd, Md, Md, Gg
