Qlf         , Qlf         , Uh          , Xu          , Xu          , Uh          , Uu^Tf       , Uu          , Uu          , Uu          , Xu          , Xu          , Uh          , Uh          , Xu          , Uu          , Uu          , Uh          , Uu          , Xu          , Qlf         , Qlf         , Qlf         
Qlf         , Qlf         , Uu^Tf       , Xu          , Rb          , Xu          , Rb          , Xu          , Rb          , Xu          , Rb          , Xu          , Rb          , Xu          , Rb^Fmf      , Xu          , Rb          , Xu          , Rb          , Xu          , Rb^Es       , Qlf         , Qlf         
Uu          , Qlf         , Rb          , Rb^Es       , Rb          , Rb          , Hhd^Fp      , Rb          , Rb^Fdw      , Rb          , Rb^Es       , Rb          , Rb          , Wwf         , Uu          , Rb          , Rb^Es       , Rb^Fmw      , Rb          , Rb^Es       , Rb          , Qlf         , Uu          
Uu          , Rb^Fmf      , Rb^Fdw      , Rb          , Rb^Es       , Sm          , Hhd         , Md          , Wwf         , Wwf         , Wwf         , Rb^Fp       , Wwf         , Wwf         , Uu^Tf       , Sm          , Rb          , Rb          , Hhd         , Rb          , Sm          , Uu          , Uu          
Uu          , Uu          , Rb          , Rb^Es       , Rb          , Rb          , Rb          , Wwf         , Uu^Vud      , Uu^Tf       , Rb          , Wwf         , Rb          , Rb^Es       , Rb^Es       , Rb          , Rb          , Hhd^Fdf     , Rb^Br/      , Rb^Br\      , Rb^Br\      , Rb^Fdf      , Qlf         
Qlf         , Qlf         , Mv^Vd       , Rb          , Rb          , Rb          , Uh          , Wwf         , Rb^Es       , Rb          , Rb          , Wwf         , Rb          , Rb          , Rb          , Rb          , Rb          , Rb          , Rb^Br|      , Mv^Vud      , Rb^Br|      , Qlf         , Qlf         
Uu^Br/      , Uu^Br\      , Rb^Br/      , Rb^Br|      , Rb^Br\      , Uu          , Uu          , Wwf         , Rb          , Uu          , Rb^Fdf      , Wwf         , Wwf         , Wwf         , Wwf         , Rb          , Rb^Fdw      , Rb^Es       , Rb          , Rb^Br\      , Rb^Br|      , Uu^Br\      , Uu^Br\      
Xu          , Rb^Es       , Rb          , Rb          , Rb          , Rb^Br|      , Cud         , Wwf         , Rb          , Sm          , Rb^Fmf      , Wwf         , Uu          , Uu          , Hhd^Fmf     , Wwf         , Cud         , Hhd         , Rb          , Rb^Fmf      , Rb^Br|      , Md          , Hhd         
Xu          , Rb          , Rb          , Uu^Tf       , Sm          , Rb^Br|      , Kud         , Wwf         , Wwf         , Rb          , Rb^Es       , Wwf         , Uu^Tf       , Uh          , Rb          , Wwf         , Kud         , Urb         , Rb^Br/      , Rb^Br/      , Rb^Es       , Uu^Tf       , Uu          
Sm          , Rb          , Rb          , Rb^Fp       , Rb          , Rb^Br|      , Urb         , Hhd^Fmw     , Wwf         , Rb^Fdw      , Wwf         , Wwf         , Wwf         , Rb^Fmw      , Wwf         , Wwf         , Rb^Br/      , Rb^Br/      , Rb          , Rb          , Rb^Es       , Rb^Es       , Xu          
Uu^Tf       , Uu^Vud      , Rb          , Rb          , Rb          , Rb^Br|      , Rb          , Hhd         , Md          , Wwf         , Xu          , Xu          , Xu          , Wwf         , Rb          , Rb^Es       , Rb^Br|      , Hhd^Fmw     , Rb          , Rb          , Rb          , Rb^Fmw      , Rb^Fmf      
Uh          , Rb^Es       , Hhd         , Rb^Es       , Rb          , Rb^Br|      , Rb          , Rb          , Rb          , Wwf         , Xu          , Qlf         , Xu          , Wwf         , Hhd         , Uh^Tf       , Rb^Br|      , Rb          , Rb          , Rb          , Rb^Fp       , Uu^Vu       , Sm          
Xu          , Rb^Fmw      , Rb^Fmf      , Rb          , Rb          , Uu^Br|      , Uu^Br\      , Rb^Es       , Rb          , Wwf         , Wwf         , Xu          , Wwf         , Wwf         , Wwf         , Wwf         , Wwf^Br|     , Rb^Es       , Rb^Fdw      , Uu          , Rb          , Rb          , Xu          
Uu          , Rb          , Rb          , Rb          , Rb          , Uu^Vu       , Uu^Br|      , Uh          , Uu          , Uu^Tf       , Wwf         , Xu          , Wwf         , Rb^Es       , Rb          , Uu^Vd       , Uu^Br|      , Wwf         , Wwf         , Uu          , Wwf         , Rb          , Wwf         
Sm          , Rb          , Rb          , Rb          , Rb^Es       , Rb          , Rb^Br|      , Urb         , Urb         , Wwf         , Cud         , Xu          , Wwf         , Rb^Fdf      , Rb          , Rb^Es       , Rb^Br|      , Rb          , Rb          , Wwf         , Cud         , Wwf         , Urb         
Uu          , Hhd         , Cud         , Uh^Tf       , Rb          , Sm          , Rb^Br|      , Rb^Fp       , Urb         , Cud         , Kud         , Xu          , Cud         , Urb         , Urb         , Rb          , Rb^Br|      , Md          , Hhd^Fmw     , Rb          , 2 Kud       , Cud         , Urb         
Urb         , Cud         , 1 Kud       , Rb          , Hhd^Fmw     , Hhd^Fdf     , Rb^Br|      , Rb^Es       , Urb         , Cud         , Cud         , Xu          , Kud         , Cud         , Urb         , Rb^Es       , Rb^Br|      , Hhd^Fp      , Rb          , Rb^Es       , Cud         , Cud         , Uu          
Urb         , Cud         , Cud         , Rb          , Rb          , Md          , Rb^Br|      , Rb          , Rb          , Urb         , Wwf         , Xu          , Cud         , Cud         , Urb         , Rb^Fmf      , Rb^Br|      , Sm          , Rb          , Uh^Tf       , Rb          , Hhd         , Sm          
Wwf         , Wwf         , Wwf         , Wwf         , Wwf         , Rb          , Uu^Br|      , Rb          , Rb          , Rb^Fdw      , Wwf         , Xu          , Wwf         , Wwf         , Uu          , Urb         , Uu^Br|      , Rb          , Rb          , Rb          , Rb          , Rb          , Uu^Tf       
Uu          , Rb          , Rb          , Uu          , Rb^Fp       , Wwf         , Wwf^Br|     , Uu^Vu       , Wwf         , Rb          , Wwf         , Xu          , Wwf         , Uu^Tf       , Rb          , Uh          , Uu^Br\      , Uu^Vu       , Rb          , Rb^Es       , Rb^Fmw      , Rb          , Xu          
Sm          , Rb^Es       , Rb^Fmw      , Uu          , Rb          , Rb^Es       , Rb^Br|      , Wwf         , Hhd         , Wwf         , Xu          , Xu          , Xu          , Wwf         , Rb^Es       , Rb^Es       , Rb          , Uu^Br\      , Rb          , Rb          , Hhd         , Rb^Fp       , Xu          
Rb^Fmf      , Uu^Vud      , Rb          , Rb          , Rb          , Rb          , Rb^Br|      , Uh^Tf       , Rb^Es       , Wwf         , Xu          , Qlf         , Xu          , Wwf         , Md          , Rb          , Rb          , Rb^Br|      , Rb          , Rb          , Rb^Es       , Rb          , Uu^Tf       
Xu          , Rb^Fdw      , Rb^Es       , Rb          , Rb          , Hhd^Fmf     , Rb^Br/      , Rb          , Wwf         , Wwf         , Wwf         , Xu          , Wwf         , Wwf         , Wwf         , Hhd         , Urb         , Rb^Br|      , Rb^Es       , Rb          , Rb          , Uu^Vd       , Sm          
Xu          , Rb          , Rb          , Rb          , Rb^Br/      , Rb^Br/      , Kud         , Wwf         , Rb          , Rb^Fdw      , Uu^Tf       , Wwf         , Rb          , Rb^Fdf      , Wwf         , Hhd^Fmf     , Kud         , Rb^Br|      , Sm          , Rb^Fdw      , Rb          , Rb          , Uh          
Hhd         , Uu^Tf       , Rb^Br|      , Rb^Br/      , Rb          , Urb         , Cud         , Wwf         , Hhd^Fmw     , Uh          , Uu          , Wwf         , Rb^Fmw      , Rb^Es       , Rb          , Wwf         , Cud         , Rb^Br|      , Rb          , Uu^Tf       , Rb          , Rb^Es       , Xu          
Uu^Br\      , Md          , Rb^Br|      , Rb^Fdf      , Rb          , Hhd         , Rb^Fdw      , Wwf         , Wwf         , Uu          , Wwf         , Wwf         , Rb^Fp       , Sm          , Rb^Es       , Wwf         , Uu          , Rb^Br\      , Rb^Br\      , Rb^Es       , Rb^Br/      , Rb          , Uu^Br/      
Qlf         , Uu^Br\      , Rb^Br|      , Rb^Br\      , Rb^Br|      , Rb^Es       , Rb          , Rb          , Rb          , Wwf         , Rb          , Wwf         , Rb          , Uu          , Rb          , Wwf         , Uh          , Uu          , Rb^Es       , Rb^Br|      , Mv^Vud      , Uu^Br\      , Qlf         
Qlf         , Qlf         , Rb^Br|      , Mv^Vd       , Rb^Br/      , Rb          , Rb^Es       , Rb          , Rb          , Rb^Es       , Rb          , Wwf         , Rb^Es       , Rb          , Uu^Vud      , Wwf         , Rb          , Rb^Es       , Rb^Es       , Rb          , Rb          , Qlf         , Uu          
Uu          , Rb^Fmf      , Sm          , Rb^Br\      , Hhd         , Hhd^Fdw     , Rb          , Rb          , Uu^Tf       , Rb          , Wwf         , Wwf         , Wwf         , Uu^Tf       , Wwf         , Wwf         , Hhd         , Rb          , Rb          , Rb          , Rb^Fdf      , Uu          , Uu          
Uu          , Uu          , Rb          , Rb          , Rb          , Rb          , Rb^Es       , Sm          , Uu          , Wwf         , Rb^Es       , Rb^Fmf      , Rb          , Wwf         , Rb^Fdw      , Md          , Hhd^Fmw     , Sm          , Rb          , Rb          , Rb          , Rb^Fmw      , Uu          
Qlf         , Qlf         , Rb^Es       , Rb          , Rb^Fp       , Rb          , Rb          , Rb          , Rb^Fmw      , Wwf         , Rb          , Rb          , Rb          , Rb          , Rb^Es       , Rb^Es       , Rb          , Rb          , Rb          , Rb^Es       , Uu^Tf       , Qlf         , Qlf         
Qlf         , Qlf         , Xu          , Xu          , Xu          , Xu          , Uu          , Uh          , Uu          , Wwf         , Rb^Fmf      , Rb^Fp       , Xu          , Uh          , Uu          , Uu          , Uu^Tf       , Xu          , Xu          , Uh          , Uh          , Qlf         , Qlf         
