Xv, Xv, Xv, Xv, Xv, Xv, Xv, Xv, Xv, Xv, Xv, Xv, Xv, Xv, Xv, Xv, Xv, Xv, Xv, Xv, Xv, Xv, Xv, Xv, Xv, Xv, Xv, Xv, Xv, Xv, Xv, Xv
Xv, Xv, Xv, Xv, Xv, Xv, Xv, Xv, Xv, Xv, Xv, Xv, Xv, Xv, Xv, Xv, Xv, Xv, Xv, Xv, Xv, Xv, Xv, Xv, Xv, Xv, Xv, Xv, Xv, Xv, Xv, Xv
Xv, Xv, Xv, Xv, Xv, Xv, Xv, Xv, Xv, Xv, Xv, Xv, Xv, Xv, Qlf, Qlf, Qlf, Xv, Xv, Xv, Xv, Xv, Xv, Xv, Xv, Xv, Xv, Xv, Xv, Xv, Xv, Xv
Xv, Xv, Xv, Xv, Xv, Xv, Xv, Xv, Xv, Xv, Xv, Xv, Qlf, Qlf, Gd^Fdw, Wwf, Hhd^Fdw, Qlf, Qlf, Xv, Xv, Xv, Xv, Xv, Xv, Xv, Xv, Xv, Xv, Xv, Xv, Xv
Xv, Xv, Xv, Xv, Xv, Xv, Xv, Xv, Xv, Xv, Qlf, Qlf, Rd, Uu^Tf, Ds, Wwf, Wwf, Qlf, Rd, Qlf, Qlf, Xv, Xv, Xv, Xv, Xv, Xv, Xv, Xv, Xv, Xv, Xv
Xv, Xv, Xv, Xv, Xv, Xv, Xv, Xv, Qlf, Qlf, Uu^Tf, Rd, Hhd, Cf, Ur, Ur, Ur, Wwf, Hhd, Gd^Fdw, Rd, Qlf, Qlf, Xv, Xv, Xv, Xv, Xv, Xv, Xv, Xv, Xv
Xv, Xv, Xv, Xv, Xv, Xv, Qlf, Qlf, Uu, Qlf, Ur, Ql, Gd^Fdw, Ur, Uu^Vud, Uh, Uu^Tf, Wwf, Md, Ur, Ur, Ds, Uu^Vu, Qlf, Qlf, Xv, Xv, Xv, Xv, Xv, Xv, Xv
Xv, Xv, Xv, Xv, Qlf, Qlf, Uu, Uu, Md, Gd^Fdw, Ur, Uu, Ur, Ur, Gd^Fdw, Xu, Uh, Wwf, Ur, Ur, Ur, Ds, Md, Ur, Ur, Qlf, Qlf, Xv, Xv, Xv, Xv, Xv
Xv, Xv, Qlf, Qlf, Gd^Fdw, Gd^Fdw, Ur, Ur, Ur, Hhd, Ur, Ur, Ur, Ur, Ur, Uu, Wwf, Wwf, Wwf, Ur, Gd^Fdw, Ur, Ur, Re^Tf, Ds, Ur, Ur, Qlf, Qlf, Xv, Xv, Xv
Xv, Qlf, Uu, Uu^Vud, Ur, Ur, Ql, Uu, Mm, Ur, Ur, Cf, Gd^Fdw, Ur, Ww, Wwf, Ur, Cf, Gd^Fdw, Wwf, Wwf, Hhd^Fdw, Hhd, Ur, Ql, Ds, Ur, Uu^Vu, Uu, Qlf, Xv, Xv
Xv, Qlf, Uu, Ql, Rr, Ur, Wwf, Wwf, Wwf, Wwf, Wwf, Uu^Vud, Wwf, Wwf, Ww^Bw/, Ur, Ur, Ur, Ur, Ur, Sm^Vhs, Ur, Ds, Ur, Ur, Re^Tf, Rr, Rr, Uu, Qlf, Xv, Xv
Xv, Qlf, Uu, Cf, Cf, Wwf, Ur, Ur, Ur, Ww, Ur, Wwf, Ur, Ur, Ww^Wkf, Ww^Wkf, Md, Hhd, Uu, Ur, Uu^Tf, Sm, Hhd^Fdw, Ur, Ur, Rr, Cf, Cf, Uu, Qlf, Xv, Xv
Xv, Qlf, Uu, 1 Kf, Cf, Rr, Ur, Ur, Hhd^Fdw, Ww, Uu^Tf, Ur, Uu, Gd^Fdw, Md, Wo, Ww^Wkf, Gd^Fdw, Ur, Ur, Ur, Ww, Ur, Ur, Ur, Rr, Cf, 2 Kf, Uu, Qlf, Xv, Xv
Xv, Qlf, Uu, Cf, Rr, Rr, Ur, Ur, Ds, Sm, Sm^Vhs, Ur, Ur, Hhd, Ur, Ww^Wkf, Ww^Bw/, Ur, Wwf, Wwf, Wwf, Ww, Wwf, Ur, Wwf, Wwf, Rr, Cf, Uu, Qlf, Xv, Xv
Xv, Qlf, Uu, Rr, Ur, Re^Tf, Ql, Ur, Hhd, Ur, Wwf, Ur, Gd^Fdw, Ur, Ur, Ur, Ww, Wwf, Gd^Fdw, Uu^Vud, Ur, Wwf, Md, Wwf, Ql, Ur, Ur, Ql, Uu, Qlf, Xv, Xv
Xv, Qlf, Qlf, Uu^Vud, Rd, Ds, Ds, Ur, Ur, Hhd^Fdw, Gd^Fdw, Wwf, Wwf, Cf, Wwf, Wwf, Ur, Ur, Ur, Cf, Ur, Ur, Ur, Uu, Ur, Ur, Gd^Fdw, Uu^Vu, Qlf, Qlf, Xv, Xv
Xv, Xv, Xv, Qlf, Qlf, Rd, Rd, Uu^Tf, Md, Ur, Ur, Ur, Ur, Wwf, Uh, Uu, Gd^Fdw, Ur, Ur, Ur, Ur, Hhd, Md, Ur, Uu, Gd^Fdw, Qlf, Qlf, Xv, Xv, Xv, Xv
Xv, Xv, Xv, Xv, Xv, Qlf, Qlf, Rd, Uu^Vud, Ds, Ur, Ur, Md, Wwf, Uu^Tf, Xu, Uu^Vu, Ur, Gd^Fdw, Uu, Ur, Gd^Fdw, Uu, Uu, Qlf, Qlf, Xv, Xv, Xv, Xv, Xv, Xv
Xv, Xv, Xv, Xv, Xv, Xv, Xv, Qlf, Qlf, Ds, Rd, Ur, Hhd, Wwf, Ur, Uh, Ur, Ur, Hhd, Ql, Uu^Tf, Qlf, Qlf, Qlf, Xv, Xv, Xv, Xv, Xv, Xv, Xv, Xv
Xv, Xv, Xv, Xv, Xv, Xv, Xv, Xv, Xv, Qlf, Qlf, Gd^Fdw, Rd, Wwf, Wwf, Ur, Ds, Cf, Rd, Rd, Qlf, Qlf, Xv, Xv, Xv, Qlf, Qlf, Xv, Xv, Xv, Xv, Xv
Xv, Qlf, Xv, Qlf, Xv, Qlf, Xv, Xv, Xv, Xv, Xv, Qlf, Qlf, Qlf, Hhd^Fdw, Wwf, Gd^Fdw, Uu^Tf, Qlf, Qlf, Xv, Xv, Xv, Xv, Xv, Qlf, Qlf, Xv, Qlf, Qlf, Qlf, Xv
Xv, Qlf, Qlf, Qlf, Qlf, Qlf, Xv, Xv, Xv, Xv, Xv, Xv, Xv, Qlf, Qlf, Wwf, Qlf, Qlf, Xv, Xv, Xv, Xv, Xv, Xv, Xv, Qlf, Qlf, Xv, Qlf, Ql, Qlf, Xv
Xv, Xv, Xv, Qlf, Xv, Xv, Xv, Xv, Xv, Xv, Xv, Xv, Xv, Xv, Xv, Qlf, Xv, Xv, Xv, Xv, Xv, Xv, Xv, Xv, Xv, Qlf, Qlf, Xv, Xv, Qlf, Xv, Xv
Xv, Xv, Xv, Qlf, Xv, Xv, Xv, Xv, Xv, Xv, Xv, Xv, Xv, Xv, Xv, Xv, Xv, Xv, Xv, Xv, Xv, Xv, Xv, Xv, Xv, Qlf, Xv, Xv, Xv, Qlf, Xv, Xv
Xv, Xv, Xv, Qlf, Xv, Xv, Xv, Xv, Xv, Xv, Xv, Xv, Xv, Xv, Xv, Xv, Xv, Xv, Xv, Xv, Xv, Xv, Xv, Xv, Xv, Qlf, Xv, Xv, Xv, Qlf, Xv, Xv
Xv, Xv, Xv, Qlf, Xv, Xv, Xv, Xv, Xv, Xv, Xv, Xv, Xv, Xv, Xv, Xv, Xv, Xv, Xv, Xv, Xv, Xv, Xv, Xv, Xv, Qlf, Xv, Xv, Xv, Qlf, Xv, Xv
Xv, Xv, Xv, Xv, Xv, Xv, Xv, Xv, Xv, Xv, Xv, Xv, Xv, Xv, Xv, Xv, Xv, Xv, Xv, Xv, Xv, Xv, Xv, Xv, Xv, Xv, Xv, Xv, Xv, Xv, Xv, Xv
Xv, Xv, Xv, Xv, Xv, Xv, Xv, Xv, Xv, Xv, Xv, Xv, Xv, Xv, Xv, Xv, Xv, Xv, Xv, Xv, Xv, Xv, Xv, Xv, Xv, Xv, Xv, Xv, Xv, Xv, Xv, Xv
Xv, Xv, Xv, Xv, Xv, Xv, Xv, Xv, Xv, Xv, Xv, Xv, Xv, Xv, Xv, Xv, Xv, Xv, Xv, Xv, Xv, Xv, Xv, Xv, Xv, Xv, Xv, Xv, Xv, Xv, Xv, Xv
