Isa, Xu, Xu, Xu, Xu, Xu, Isa, Isa, Xos, Xos, Xos, Kud, Xos, Kud, Xos, Kud, Xos, Xos, Xos, Isa, Isa, Xu, Xu, Xu, Xu, Xu, Isa
Xos, Isa, Isa, Xu, Isa, Isa, Xos, Xos, Rp, Rp, Uu, Xos, Cf, Xos, Cf, Xos, Uu, Rp, Rp, Xos, Xos, Isa, Isa, Xu, Isa, Isa, Xos
Xos, Xos, Isa, Isa, Isa, Xos, Rp, Rp, Uu, Xos, Gg^Efm, Uu, Cf, 1 Kf, Cf, Uu, Gg^Efm, Xos, Uu, Rp, Rp, Xos, Isa, Isa, Isa, Xos, Xos
Xos, Xos, Xos, Isa, Xos, Xos, Uu, Xos, Gg^Ve, Gg^Efm, Gg, Gg, Rr, Cf, Rr, Gg, Gg, Gg^Efm, Gg^Ve, Xos, Uu, Xos, Xos, Isa, Xos, Xos, Xos
Xos, Ch, Ds, Xos, Xos, Xos, Rr, Gg^Efm, Gg, Gg, Gg^Fet, Gg, Rr, Rr, Rr, Gg, Gg^Fet, Gg, Gg, Gg^Efm, Rr, Xos, Xos, Xos, Ds, Ch, Xos
Xos, Rp, Xos, Uu, Gg^Efm, Rr, Gg, Gg, Gg^Fet, Gg, Re^Gvs, Rr, Rr, Rr, Rr, Rr, Re^Gvs, Gg, Gg^Fet, Gg, Gg, Rr, Gg^Efm, Uu, Xos, Rp, Xos
Xos, Rp, Uu, Gg^Ve, Gg, Gg, Gg^Fet, Gg, Re^Gvs, Re^Gvs, Rr, Rr, Rr, Rp^Vhc, Rr, Rr, Rr, Re^Gvs, Re^Gvs, Gg, Gg^Fet, Gg, Gg, Gg^Ve, Uu, Rp, Xos
Xos, Rp, Xos, Gg^Efm, Gg^Fet, Gg, Re^Gvs, Re^Gvs, Kv, Rr, Rr, Rr, Gg^Fet, Gg^Efm, Gg^Fet, Rr, Rr, Rr, Kv, Re^Gvs, Re^Gvs, Gg, Gg^Fet, Gg^Efm, Xos, Rp, Xos
Xos, Rp, Cf, Gg^Efm, Re^Gvs, Re^Gvs, Rr, Cv, Cv, Cv, Rd, Hh^Fp, Mm, Cv, Mm, Hh^Fp, Rd, Cv, Cv, Cv, Rr, Re^Gvs, Re^Gvs, Gg^Efm, Cf, Rp, Xos
Xos, Rp, Xos, Ss, Re^Gvs, Rr, Rr, Rr, Gg^Efm, Ss, Gg^Efm, Rd, Rd, Hh, Rd, Rd, Gg^Efm, Ss, Gg^Efm, Rr, Rr, Rr, Re^Gvs, Ss, Xos, Rp, Xos
Xos, Rp, Uu, Hh, Rp^Vhc, Rr, Rr, Hh, Gg^Fet, Gg, Ds, Gg^Efm, Rd, Gg^Vh, Rd, Gg^Efm, Gg^Efm, Gg, Gg^Fet, Hh, Rr, Rr, Rp^Vhc, Hh, Uu, Rp, Xos
Xos, Rp, Xos, Gg^Efm, Re, Rr, Rr, Gg^Efm, Gg, Gg, Wwr, Mm, Gg^Fet, Wwf, Ss, Mm, Wwr, Gg, Gg, Gg^Efm, Rr, Rr, Re, Gg^Efm, Xos, Rp, Xos
Xos, Rp, Rp, Gg^Efm, Hh^Fp, Rr, Rr, Rr, Gg, Hh, Cv, Hh, Wwf, Wwf, Wwf, Hh, Gg^Efm, Gg, Gg^Fet, Rr, Rr, Rr, Gg^Fet, Gg^Efm, Rp, Rp, Xos
Xos, Ds, Cf, Hh, Mm^Xm, Gg^Fet, Rr, Rr, Hh^Fp, Gg, Gg^Efm, Wwf, Ww, Ww, Ww, Wwf, Gg^Efm, Hh, Hh^Fp, Rr, Rr, Hh, Mm^Xm, Mm, Cf, Ds, Xos
Xos, Ds, Rp, Mm, Gg^Fet, Hh, Rr, Rr, Gg^Fet, Hh, Gg^Efm, Wwf, Wwf, Ww, Wwf, Wwf, Cv, Gg, Gg, Rr, Rr, Gg^Fet, Hh^Fp, Hh, Rp, Ds, Xos
Xos, Rp, Xos, Gg^Efm, Re, Rr, Rr, Rr, Gg, Gg, Wwr, Hh, Ss, Wwf, Gg^Fet, Hh, Wwr, Hh, Gg, Rr, Rr, Rr, Re, Gg^Efm, Xos, Rp, Xos
Xos, Rp, Uu, Gg^Efm, Rp^Vhc, Rr, Rr, Gg^Efm, Gg^Fet, Gg, Gg^Efm, Mm, Rd, Wwf, Rd, Mm, Ds, Gg, Gg^Fet, Gg^Efm, Rr, Rr, Rp^Vhc, Gg^Efm, Uu, Rp, Xos
Xos, Rp, Xos, Hh, Re^Gvs, Rr, Rr, Hh, Gg^Efm, Gg, Gg^Efm, Gg^Efm, Rd, Gg^Vh, Rd, Gg^Efm, Gg^Efm, Gg, Gg^Efm, Hh, Rr, Rr, Re^Gvs, Hh, Xos, Rp, Xos
Xos, Rp, Cf, Ss, Re^Gvs, Rr, Rr, Rr, Cv, Ss, Rd, Rd, Mm, Hh, Mm, Rd, Rd, Ss, Cv, Rr, Rr, Rr, Re^Gvs, Ss, Cf, Rp, Xos
Xos, Rp, Xos, Gg^Efm, Gg^Fet, Re^Gvs, Re^Gvs, Cv, Kv, Cv, Rr, Hh^Fp, Gg^Fet, Cv, Gg^Fet, Hh^Fp, Rr, Cv, Kv, Cv, Re^Gvs, Re^Gvs, Gg^Fet, Gg^Efm, Xos, Rp, Xos
Xos, Rp, Uu, Gg^Efm, Gg^Ve, Gg, Gg^Fet, Re^Gvs, Re^Gvs, Rr, Rr, Rr, Rr, Gg^Efm, Rr, Rr, Rr, Rr, Re^Gvs, Re^Gvs, Gg^Fet, Gg, Gg^Ve, Gg^Efm, Uu, Rp, Xos
Xos, Rp, Xos, Uu, Uu, Gg^Efm, Gg, Gg, Gg^Fet, Re^Gvs, Re^Gvs, Rr, Rr, Rp^Vhc, Rr, Rr, Re^Gvs, Re^Gvs, Gg^Fet, Gg, Gg, Gg^Efm, Uu, Uu, Xos, Rp, Xos
Xos, Cf, Xos, Xos, Xos, Uu, Uu, Gg, Gg^Efm, Gg, Gg^Fet, Rr, Rr, Rr, Rr, Rr, Gg^Fet, Gg, Gg^Efm, Gg, Uu, Uu, Xos, Xos, Xos, Cf, Xos
Isa, Xos, Isa, Isa, Isa, Xos, Rp, Xos, Uu, Gg^Ve, Gg^Efm, Gg, Rr, Rr, Rr, Gg, Gg^Efm, Gg^Ve, Xos, Uu, Rp, Xos, Isa, Isa, Isa, Xos, Isa
Xu, Isa, Xu, Isa, Isa, Xos, Xos, Rp, Rp, Uu, Xos, Gg^Efm, Cf, Cf, Cf, Gg^Efm, Xos, Uu, Rp, Rp, Xos, Xos, Isa, Isa, Xos, Isa, Xos
Xu, Xu, Isa, Isa, Xu, Isa, Isa, Xos, Xos, Rp, Rp, Uu, Cf, 2 Kf, Cf, Uu, Rp, Rp, Xos, Xos, Isa, Isa, Xos, Isa, Isa, Xos, Xos
Isa, Isa, Xu, Xu, Xu, Xu, Xu, Isa, Isa, Xos, Xos, Xos, Xos, Xos, Xos, Xos, Xos, Xos, Isa, Isa, Xos, Xos, Xos, Xos, Xos, Isa, Isa
