border_size=1
usage=map

_off^_usr          , _off^_usr          , _off^_usr          , _off^_usr          , _off^_usr          , _off^_usr          , _off^_usr          , _off^_usr          , _off^_usr          , _off^_usr          , _off^_usr          , _off^_usr          , _off^_usr          , _off^_usr          , _off^_usr          , _off^_usr          , _off^_usr          , _off^_usr          , Uu^Tf       , _off^_usr          , _off^_usr          , _off^_usr          , _off^_usr          , _off^_usr          , _off^_usr          , _off^_usr          , Uu^Tf       , _off^_usr          , _off^_usr          , _off^_usr          , _off^_usr          , _off^_usr          , _off^_usr          , _off^_usr          , _off^_usr          , _off^_usr          , _off^_usr          , _off^_usr          , _off^_usr          , _off^_usr          , _off^_usr          , _off^_usr          , _off^_usr          , _off^_usr          , _off^_usr          
_off^_usr          , _off^_usr          , _off^_usr          , _off^_usr          , _off^_usr          , _off^_usr          , _off^_usr          , _off^_usr          , _off^_usr          , _off^_usr          , _off^_usr          , _off^_usr          , Uh          , Uh          , Uu^Es       , Rb          , Sm^Fdw      , Uu          , Rb          , Uh          , Wwg         , Sm^Fmw      , Uu^Es       , Sm^Fdw      , Wwg         , Uh          , Rb          , Uu^Es       , Sm^Fdf      , Rb          , Uu^Es       , Uh          , Uh          , _off^_usr          , _off^_usr          , _off^_usr          , _off^_usr          , _off^_usr          , _off^_usr          , _off^_usr          , _off^_usr          , _off^_usr          , _off^_usr          , _off^_usr          , _off^_usr          
_off^_usr          , _off^_usr          , _off^_usr          , _off^_usr          , _off^_usr          , _off^_usr          , _off^_usr          , _off^_usr          , _off^_usr          , _off^_usr          , Ds          , Wwf         , Wwf         , Uu^Tf       , Wwf         , Rb          , Rb          , Sm          , Uu^Tf       , Wwg         , Rb          , Wwf         , Wwf         , Wwf         , Rb          , Wwg         , Uu^Tf       , Sm          , Rb          , Rb          , Wwf         , Uu^Tf       , Wwf         , Wwf         , Ds          , _off^_usr          , _off^_usr          , _off^_usr          , _off^_usr          , _off^_usr          , _off^_usr          , _off^_usr          , _off^_usr          , _off^_usr          , _off^_usr          
_off^_usr          , _off^_usr          , _off^_usr          , _off^_usr          , _off^_usr          , _off^_usr          , _off^_usr          , _off^_usr          , Wwf         , Rb^Tf       , Ds^Fet      , Wwf         , Wwg         , Wwg         , Gs^Es       , Wwf^Bs/     , Uh          , Rb          , Wwf         , Wwf         , Sm^Fdf      , Uu^Es       , Wwf         , Uu          , Sm^Fmw      , Wwf         , Wwf         , Rb          , Uh          , Wwf^Bs\     , Gs^Es       , Wwg         , Wwg         , Wwf         , Ds^Fet      , Rb^Tf       , Wwf         , _off^_usr          , _off^_usr          , _off^_usr          , _off^_usr          , _off^_usr          , _off^_usr          , _off^_usr          , _off^_usr          
_off^_usr          , _off^_usr          , _off^_usr          , _off^_usr          , _off^_usr          , _off^_usr          , Gg          , Ss          , Ss          , Rb          , Rb          , Ds          , Gs          , Gs          , Wwg         , Wwg         , Wwg         , Wwf         , Uu^Vo       , Uh          , Uu^Tf       , Rb          , Wog         , Rb          , Uu^Tf       , Uh          , Uu^Vu       , Wwf         , Wwg         , Wwg         , Wwg         , Gs          , Gs          , Ds          , Rb          , Rb          , Ss          , Ss          , Gg          , _off^_usr          , _off^_usr          , _off^_usr          , _off^_usr          , _off^_usr          , _off^_usr          
_off^_usr          , _off^_usr          , _off^_usr          , _off^_usr          , Ds          , Ds          , Hh          , Gs^Es       , Gs^Es       , Hh^Fms      , Mm          , Gg          , Gg          , Gs^Fds      , Ce          , Ds          , Ds          , Wwf         , Rb          , Uu^Es       , Uu^Es       , Wog         , Wog         , Wog         , Uu          , Uu^Es       , Rb          , Wwf         , Ds          , Ds          , Ce          , Gs^Fms      , Gg          , Gs^Es       , Mm          , Hh^Fms      , Gs          , Gg          , Hh          , Ds          , Ds          , _off^_usr          , _off^_usr          , _off^_usr          , _off^_usr          
_off^_usr          , _off^_usr          , Wwf         , Wwf         , Wwf         , Ww          , Ww          , Gs          , Gs^Fms      , Gs          , Gg          , Gs          , Hh^Fds      , Ce          , Ke          , Rb          , Rb          , Wwf^Bs/     , Wwg         , Wwg         , Wwf         , Wwf         , Ds          , Wwf         , Wwf         , Wwg         , Wwg         , Wwf^Bs\     , Rb          , Rb          , Ke          , Ce          , Hh^Fds      , Gs          , Gs          , Gs          , Gs^Fds      , Gs^Es       , Ww          , Ww          , Wwf         , Wwf         , Wwf         , _off^_usr          , _off^_usr          
_off^_usr          , _off^_usr          , Ce          , Ce          , Ce          , Ce          , Ce          , Ww          , Ww          , Ds          , Ds          , Gs^Es       , Rp          , Rp          , Ce          , Ce          , Wwg         , Rb          , Wog^Bw\     , Wwg         , Wwf         , Uu^Es       , Uu^Tf       , Uu          , Wwf         , Wwg         , Wog^Bw/     , Rb          , Wwg         , Ce          , Ce          , Rp          , Rp          , Gg          , Ds          , Ds          , Ww          , Ww          , Ce          , Ce          , Ce          , Ce          , Ce          , _off^_usr          , _off^_usr          
_off^_usr          , _off^_usr          , Re          , Re          , Re          , Re          , Re          , Ce          , Ce          , Ww          , Wo^Bw/      , Rp          , Gs^Es       , Gg          , Hh          , Gs          , Gg          , Wwg         , Ds          , Gs          , Gs^Es       , Rb          , Rb^Es       , Rb          , Gs          , Gs^Es       , Ds          , Wwg         , Gs          , Gs          , Gs          , Hh          , Gs^Es       , Rp          , Wo^Bw\      , Ww          , Ce          , Ce          , Re          , Re          , Re          , Re          , Re          , _off^_usr          , _off^_usr          
_off^_usr          , _off^_usr          , Hh^Fds      , Mm          , Hh          , Re          , Gs^Fet      , Re          , Re          , Ket         , Ww          , Gs          , Gs          , Gs          , Gs          , Gg^Es       , Wwf         , Wwf         , Gs^Fms      , Gg          , Hh^Fp       , Gs          , Ww          , Gs          , Hh^Fds      , Gs^Es       , Gs^Fds      , Wwf         , Wwf         , Gs          , Gs^Es       , Gs          , Gs^Es       , Gg          , Ww          , Ket         , Re          , Re          , Gs^Fet      , Re          , Hh          , Mm          , Hh^Fms      , _off^_usr          , _off^_usr          
_off^_usr          , _off^_usr          , Ww^Ewl      , Ds          , Rb^Tf       , Re^Vct      , Ww          , Hh^Fms      , Re          , Ce          , Ww          , Rr^Vhc      , Gs          , Gs          , Gs          , Rb^Tf       , Wwf         , Ds^Vc       , Ww          , Mm          , Ww          , Gs          , Ww          , Gs          , Ww          , Mm          , Ww          , Ds^Vd       , Wwf         , Rb^Tf       , Gs          , Gg          , Gs          , Rr^Vhc      , Ww          , Ce          , Re          , Hh          , Ww^Ewl      , Re^Vct      , Rb^Tf       , Ds          , Ww^Ewl      , _off^_usr          , _off^_usr          
_off^_usr          , _off^_usr          , Re          , Re          , Re          , Re          , Ww^Ewl      , Ww^Ewl      , Re          , Ce          , Ww          , Gs^Es       , Gs          , Hh^Fms      , Gs          , Gs          , Wwf         , Ds^Fms      , Ww          , Wwr         , Ww          , Wo^Bw|      , Ww          , Wo^Bw|      , Ww          , Wwr         , Ww          , Ds^Fms      , Wwf         , Gs          , Gs          , Hh^Fds      , Gg          , Gs          , Ww          , Ce          , Re          , Ww          , Ww          , Re          , Re          , Re          , Re          , _off^_usr          , _off^_usr          
_off^_usr          , _off^_usr          , Re          , Ce          , Rp          , Rp          , Rp          , Ce          , Re          , Ce          , Ww          , Gs          , Gs^Fds      , Gs          , Gg          , Gg^Es       , Ww          , Ds          , Ds          , Ww          , Wwf         , Gg          , Ds          , Gg          , Wwf         , Ww          , Ds          , Ds          , Ww          , Gs          , Gs^Es       , Gs          , Gs^Fds      , Gg          , Ww          , Ce          , Re          , Ce          , Rp          , Rp          , Rp          , Ce          , Re          , _off^_usr          , _off^_usr          
_off^_usr          , _off^_usr          , Rp          , Rp          , Ce          , Ce          , Rp          , Rp          , Rp          , Ce          , Wwf         , Rp          , Rp          , Ce          , Ce          , Mm          , Hh          , Ww          , Ds^Fds      , Wwf         , Hh          , Gs          , Gs^Es       , Gs          , Hh          , Wwf         , Ds^Fds      , Ww          , Hh          , Mm          , Ce          , Ce          , Rp          , Rp          , Wwf         , Ce          , Rp          , Rp          , Rp          , Ce          , Ce          , Rp          , Rp          , _off^_usr          , _off^_usr          
_off^_usr          , _off^_usr          , Rp          , 1 Ket       , Ce          , Ke          , Rp          , Rp^Vhc      , Rp          , Ket         , Wwf         , Rp          , Rp          , Ke          , Ce          , Ww          , Ww          , Wwf         , Ww          , Wwf         , Gs^Es       , Gg          , Hh^Fds      , Gs          , Gs          , Wwf         , Ww          , Wwf         , Ww          , Ww          , Ce          , Ke          , Rp          , Rp          , Wwf         , Ket         , Rp          , Rp^Vhc      , Rp          , Ke          , Ce          , 2 Ket       , Rp          , _off^_usr          , _off^_usr          
_off^_usr          , _off^_usr          , Re          , Rp          , Rp          , Ce          , Rp          , Rp          , Re          , Ce          , Ww          , Rp          , Wwf         , Ce          , Gg          , Gs^Fms      , Rb^Tf       , Ww          , Wwr         , Wo          , Wwf         , Gs^Fms      , Gg          , Gs^Fms      , Wwf         , Wo          , Wwr         , Ww          , Rb^Tf       , Gs^Fms      , Gs^Em       , Ce          , Wwf         , Rp          , Ww          , Ce          , Re          , Rp          , Rp          , Ce          , Rp          , Rp          , Re          , _off^_usr          , _off^_usr          
_off^_usr          , _off^_usr          , Re          , Ce          , Re          , Rp          , Ww          , Ce          , Re          , Ce          , Ww          , Wwf         , Gs          , Wwf         , Ww          , Gs^Em       , Gs          , Ww          , Gs^Fds      , Gg          , Wwf         , Ds          , Gs          , Ds          , Wwf         , Gg^Em       , Gs^Fms      , Ww          , Gs          , Gs^Em       , Ww          , Wwf         , Gs^Em       , Wwf         , Ww          , Ce          , Re          , Ce          , Ww^Ewl      , Rp          , Re          , Ce          , Re          , _off^_usr          , _off^_usr          
_off^_usr          , _off^_usr          , Ww^Ewl      , Re          , Rb^Tf       , Re          , Ww^Ewl      , Ww          , Re          , Ce          , Ww          , Gg          , Gs          , Ds          , Ds          , Ww          , Wwf         , Wo^Bw\      , Gs          , Gs          , Hh          , Wwf         , Wwr         , Wwf         , Hh          , Gs^Em       , Gs          , Wo^Bw/      , Wwf         , Ww          , Ds          , Ds          , Gs          , Gs          , Ww          , Ce          , Re          , Ww^Ewl      , Ww          , Re          , Rb^Tf       , Re          , Ww^Ewl      , _off^_usr          , _off^_usr          
_off^_usr          , _off^_usr          , Hh^Fms      , Ds          , Hh          , Re^Vct      , Gs^Fet      , Hh^Fds      , Re          , Ce          , Ww          , Rr^Vhc      , Gs          , Hh          , Gs          , Gg          , Wwf         , Hh^Ve       , Gg          , Gs^Em       , Mm          , Wwf         , Gs          , Wwf         , Mm          , Gg          , Gg          , Hh^Vl       , Wwf         , Gs          , Gs          , Hh          , Gg          , Rr^Vhc      , Ww          , Ce          , Re          , Hh          , Gs^Fet      , Re^Vct      , Hh          , Ds          , Hh^Fds      , _off^_usr          , _off^_usr          
_off^_usr          , _off^_usr          , Re          , Mm          , Re          , Re          , Re          , Re          , Ce          , Ket         , Wo^Bw\      , Ds          , Gg          , Gs^Em       , Gs          , Gs^Fms      , Ww          , Wwf         , Wo^Bw/      , Ds          , Ds^Tf       , Wwf         , Gs^Em       , Wwf         , Ds^Tf       , Ds          , Wo^Bw\      , Wwf         , Ww          , Gs^Fds      , Gg          , Gs^Em       , Gs          , Ds          , Wo^Bw/      , Ket         , Ce          , Re          , Re          , Re          , Re          , Mm          , Re          , _off^_usr          , _off^_usr          
_off^_usr          , _off^_usr          , Ce          , Re          , Ce          , Re          , Ce          , Ce          , Ww          , Ww          , Gg          , Rp          , Rp          , Gs          , Ce          , Ww          , Gg          , Gs          , Ds          , Ww          , Wo          , Ww          , Wwf         , Ww          , Wo          , Ww          , Ds          , Gg          , Gg          , Ww          , Ce          , Gg          , Rp          , Rp          , Gs^Em       , Ww          , Ww          , Ce          , Ce          , Re          , Ce          , Re          , Ce          , _off^_usr          , _off^_usr          
_off^_usr          , _off^_usr          , Wwf         , Ce          , Wwf         , Ce          , Ww          , Ww          , Hh^Fds      , Hh          , Gs          , Gs^Em       , Gs          , Rp          , Ke          , Ce          , Gs          , Gs^Ft       , Ds          , Ww          , Wwt         , Wwt         , Hd          , Wwt         , Wwt         , Ww          , Ds          , Gs^Ft       , Gs^Em       , Ce          , Ke          , Rp          , Gs^Em       , Gs          , Gs          , Hh          , Hh^Fds      , Ww          , Ww          , Ce          , Wwf         , Ce          , Wwf         , _off^_usr          , _off^_usr          
_off^_usr          , _off^_usr          , _off^_usr          , Wwf         , Ds          , Ww          , Ds          , Ds          , Gg^Em       , Gs^Fds      , Gg          , Gs^Em       , Gg          , Ce          , Ce          , Gg          , Gs^Em       , Ds          , Wwt         , Wwf         , Gs^Em       , Wwf         , Wot         , Wwf         , Gs          , Wwf         , Wwt         , Ds          , Gs^Em       , Gs          , Ce          , Ce          , Gg          , Gs          , Gg          , Gs^Fms      , Gs^Em       , Ds          , Ds          , Ww          , Ds          , Wwf         , _off^_usr          , _off^_usr          , _off^_usr          
_off^_usr          , _off^_usr          , _off^_usr          , _off^_usr          , _off^_usr          , Ds          , Hh          , Gs          , Gs^Em       , Gs^Em       , Gg          , Mm          , Hh^Fds      , Ds          , Wwt         , Hh          , Gs^Em       , Wwt         , Wot         , Wwr         , Gs          , Ds^Tf       , Wwf         , Ds^Tf       , Gs^Em       , Wwr         , Wot         , Wwt         , Gg          , Hh          , Wwt         , Ds          , Hh^Fds      , Mm          , Gg          , Gg          , Gs^Em       , Gs^Em       , Hh          , Ds          , _off^_usr          , _off^_usr          , _off^_usr          , _off^_usr          , _off^_usr          
_off^_usr          , _off^_usr          , _off^_usr          , _off^_usr          , _off^_usr          , _off^_usr          , _off^_usr          , Gg          , Gg^Fet      , Gs          , Gg          , Gg          , Gs          , Ds          , Wwr         , Wwt         , Wwf         , Wwf         , Wwf         , Hh          , Gs^Ft       , Ds^Em       , Wot         , Ds          , Gs^Ft       , Hh          , Wwf         , Wwf         , Wwf         , Wwt         , Wwr         , Ds          , Gs          , Gs^Em       , Gs          , Gs          , Gg^Fet      , Gs          , _off^_usr          , _off^_usr          , _off^_usr          , _off^_usr          , _off^_usr          , _off^_usr          , _off^_usr          
_off^_usr          , _off^_usr          , _off^_usr          , _off^_usr          , _off^_usr          , _off^_usr          , _off^_usr          , _off^_usr          , _off^_usr          , Ss          , Rd^Tf       , Gs^Em       , Gs^Ft       , Gs          , Wwt         , Wwt         , Gs          , Wwg^Vht     , Ds^Ft       , Wwt         , Wwf         , Wwf         , Hd^Ft       , Wwf         , Wwf         , Wwt         , Ds^Ft       , Wwg^Vhs     , Gs          , Wwt         , Wwt         , Gs          , Gs^Ft       , Gg          , Rd^Tf       , Ss          , _off^_usr          , _off^_usr          , _off^_usr          , _off^_usr          , _off^_usr          , _off^_usr          , _off^_usr          , _off^_usr          , _off^_usr          
_off^_usr          , _off^_usr          , _off^_usr          , _off^_usr          , _off^_usr          , _off^_usr          , _off^_usr          , _off^_usr          , _off^_usr          , _off^_usr          , _off^_usr          , Ds          , Wwf         , Gg^Em       , Wot^Bw\     , Hh          , Ds^Tf       , Ds          , Wwt         , Wwt         , Ds          , Gd^Em       , Gd          , Gd          , Ds          , Wwt         , Wwt         , Ds          , Ds^Tf       , Hh          , Wot^Bw/     , Gg          , Wwf         , Ds          , _off^_usr          , _off^_usr          , _off^_usr          , _off^_usr          , _off^_usr          , _off^_usr          , _off^_usr          , _off^_usr          , _off^_usr          , _off^_usr          , _off^_usr          
_off^_usr          , _off^_usr          , _off^_usr          , _off^_usr          , _off^_usr          , _off^_usr          , _off^_usr          , _off^_usr          , _off^_usr          , _off^_usr          , _off^_usr          , _off^_usr          , _off^_usr          , Wwf         , Gs          , Gs^Ft       , Mm          , Hh          , Wwf         , Ds          , Hd^Ft       , Hhd         , Mv          , Hhd         , Hd^Ft       , Ds          , Wwf         , Hh          , Mm          , Gs^Ft       , Gs          , Wwf         , _off^_usr          , _off^_usr          , _off^_usr          , _off^_usr          , _off^_usr          , _off^_usr          , _off^_usr          , _off^_usr          , _off^_usr          , _off^_usr          , _off^_usr          , _off^_usr          , _off^_usr          
_off^_usr          , _off^_usr          , _off^_usr          , _off^_usr          , _off^_usr          , _off^_usr          , _off^_usr          , _off^_usr          , _off^_usr          , _off^_usr          , _off^_usr          , _off^_usr          , _off^_usr          , _off^_usr          , _off^_usr          , Hh^Fds      , _off^_usr          , _off^_usr          , _off^_usr          , _off^_usr          , _off^_usr          , Mm          , Mm          , Mm          , _off^_usr          , _off^_usr          , _off^_usr          , _off^_usr          , _off^_usr          , Hh^Fms      , _off^_usr          , _off^_usr          , _off^_usr          , _off^_usr          , _off^_usr          , _off^_usr          , _off^_usr          , _off^_usr          , _off^_usr          , _off^_usr          , _off^_usr          , _off^_usr          , _off^_usr          , _off^_usr          , _off^_usr          
