Xue, Xue, Xue, Xue, Xue, Xue, Uh, Xue, Xue, Xue, Wwf, Xue, Xue, Xue, Xue, Xue, Xue, Gd, Gs, Gs, Wwf, Wwf, Wwf, Gs, Gs, Gd, Xue, Xue, Xue, Xue, Xue, Xue, Wwf, Xue, Xue, Xue, Xue, Uh, Xue, Xue, Xue, Xue, Xue
Xue, Xue, Xue, Xue, Xue, Xue, Uh, Xue, Xue, Xue, Wwf, Xue, Gs, Xue, Gd, Gd, Gd, Gd^Efm, Cd, Cd, Cd, Wwf, Cd, Cd, Cd, Gd, Gd, Gd^Efm, Gd, Xue, Gs, Xue, Wwf, Xue, Xue, Xue, Xue, Uh, Xue, Xue, Xue, Xue, Xue
Xue, Xue, Xue, Xue, Uh, Uh, Xue, Xue, Gd, Gs, Gs, Wwf, Gs^Vdt, Gd, Rd, Rd, Rd, Rd, Cd, 3 Kd, Cd, Wwf, Cd, 4 Kd, Cd, Rd, Rd, Rd, Rd, Gd, Gs^Vdt, Wwf, Gs, Gs, Gd, Xue, Xue, Uh, Uh, Xue, Xue, Xue, Xue
Uh, Uh, Uh, Uh, Uh, Xue, Xue, Xue, Gd, Gd, Rd, Wwf, Rd, Rd, Gs, Gd, Gd, Gs, Gs, Cd, Wwf, Wwf, Wwf, Cd, Gs, Gs, Gd, Gd, Gs, Rd, Rd, Wwf, Rd, Gd, Gd, Xue, Xue, Xue, Uh, Uh, Uh, Uh, Uh
Uh, Uh, Xue, Xue, Xue, Uh, Hhd, Gd, Rd, Rd, Gs, Wwf, Wwf, Gs, Gs^Ftp, Hh, Mm, Gs^Ftp, Gs, Gs, Gs, Wwf, Gs, Gs, Gs, Gs^Ftp, Mm, Hh, Gs^Ftp, Gs, Wwf, Wwf, Gs, Rd, Rd, Gd, Hhd, Uh, Xue, Xue, Xue, Uh, Uh
Xue, Xue, Xue, Xue, Hhd, Hhd, Rd, Rd^Tf, Mm, Gs^Ftp, Hh, Gs, Wwf, Gs, Gs, Hh, Gs^Efm, Hh, Gd^Tf, Gs^Efm, Gs, Wwf, Gs, Gs^Efm, Gs^Tf, Hh, Gs, Hh, Gs, Gs, Wwf, Gs, Hh, Gd^Ftp, Mm, Rd^Tf, Rd, Hhd, Hhd, Xue, Xue, Xue, Xue
Xue, Xue, Xue, Xue, Hhd, Gd, Rd, Gd, Gd, Hh, Gd, Kdr, Gs, Wwf, Wwf, Gs^Vdt, Gs, Gs, Gs, Gs, Gs, Wwf, Gs, Gs, Gs, Gs, Gs, Gs^Vdt, Wwf, Wwf, Gs, Kdr, Gd, Hh, Gd^Efm, Gd, Rd, Gd, Hhd, Xue, Xue, Xue, Xue
Xue, Xue, Xue, Hhd^Fts, Gd^Ftp, Gd^Ftp, Rd, Gd^Ftp, Gd, Gd, Gd, Gd^Tf, Gd, Gs, Gs, Wwf, Wwf, Gs, Cdr, Gs, Gs, Wwf, Gs, Gs, Cdr, Gs, Wwf, Wwf, Gs, Gs, Gd, Gd^Tf, Gd, Gd, Gd, Gd^Ft, Rd, Gd^Ft, Gd^Ft, Hhd^Ft, Xue, Xue, Xue
Hhd, Hhd^Ftp, Hhd^Ftp, Hhd, Rd, Rd, Gd, Hhd, Gd^Vda, Gd, Gd, Gd, Gd^Efm, Gd, Gd, Gs, Wwf, Gs, Gs, Gs^Ftp, Wwf, Wwf, Wwf, Gs^Ftp, Gs, Gs, Wwf, Gs, Gd, Gd, Gd, Gd, Gd^Efm, Gd, Gd^Vda, Hhd, Gd, Rd, Rd, Hhd, Hhd^Ftp, Hhd^Ftp, Hh^Ftp
Hhd^Ftp, Hhd^Ftp, Rd, Rd, Gd^Fts, Rd, Rd, Rd, Rd, Gd^Efm, Gd, Gd, Rd, Hhd, Gd, Gs, Gs^Efm, Wwf, Wwf, Wwf, Wwf, Hh, Wwf, Wwf, Wwf, Wwf, Gs^Efm, Gs, Gd, Hhd, Rd, Gd, Gd, Gd, Rd, Rd, Rd, Rd, Gd^Ft, Rd, Rd, Hhd^Ftp, Hhd^Ftp
Dd^Ftp, Dd^Ftp, Ce, Gd, Hhd^Fts, Mm, Gd, Gd, Hhd, Rd, Ce, Rd, Gd, Hhd^Ftp, Gd, Gd, Gs, Gs^Efm, Hh, Mm, Wwf, Wwf, Wwf, Mm, Hh, Gs^Efm, Gs, Gd, Gd, Hhd^Ftp, Gd, Rd, Ce, Rd, Hhd, Gd, Gd, Mm, Hhd^Fts, Gd, Ce, Dd^Ftp, Dd^Ftp
Dd^Ftp, Ce, 1 Ke, Gd, Gd, Hhd, Gd, Gd, Mm, Gd^Ftp, Ke, Ce, Gd, Gd, Rd^Tf, Hhd, Gs, Gs, Gs^Efm, Gs^Tf, Wwf, Wwt, Wwf, Gs^Tf, Gs, Gs, Gs, Hhd, Rd^Tf, Gd, Gd, Ce, Ke, Gd^Ftp, Mm, Gd, Gd, Hhd, Gd, Gd, 2 Ke, Ce, Dd^Ftp
Dd^Ftp, Ce, Ce, Rr, Rr, Hhd, Mm^Vhh, Gd, Gd, Gd, Gd, Ce, Gd, Hhd, Mm, Rd, Gs^Vda, Gs, Wwf, Wwf, Gs^Ftp, Wwt, Gs^Ftp, Wwf, Wwf, Gs, Gs^Vda, Rd, Mm, Hhd, Gd, Ce, Gd, Gd, Gd, Gd, Mm^Vhh, Hhd, Rr, Rr, Ce, Ce, Dd^Ftp
Dd^Ftp, Dd^Ftp, Wwt, Gs, Rr, Gd^Tf, Gd, Hhd^Ftp, Gd, Gd, Gd, Gd, Gd, Hhd, Gd^Ftp, Gs, Wwf, Wwf, Gs, Gs, Gs, Wwf, Gs, Gs, Gs, Wwf, Wwf, Gs, Gd^Ftp, Hhd, Gd, Gd, Gd, Gd, Gd, Hhd^Ftp, Gd, Gd^Tf, Rr, Gs, Wwt, Dd^Ftp, Dd^Ftp
Wwf, Wwf, Wwt, Gs, Gs, Rr, Rr, Gd, Gd, Hhd, Ke, Gs, Gs, Gs, Gs, Gs, Wwf, Gs^Ftp, Gs, Gs, Gs, Wwf, Gs, Gs, Gs, Gs^Ftp, Wwf, Gs, Gs, Gs, Gs, Gs^Efm, Ke, Hhd, Gd, Gd, Rr, Rr, Gs, Gs, Wwt, Wwf, Wwf
Wwf, Wwf, Wwf, Wwt, Gs, Hhd, Gd, Rr, Rr, Gd, Ce, Gs, Wwf, Wwf, Wwf, Wwf, Gs, Mm, Gs, Gs, Gs, Wwf, Gs, Gs, Gs, Mm, Gs, Wwf, Wwf, Wwf, Wwf, Gs, Ce, Gd, Rr, Rr, Gd, Hhd, Gs, Wwt, Wwf, Wwf, Wwf
Dd^Ftp, Dd^Ftp, Wwt, Wwf, Gs, Gd, Mm, Hhd, Gd, Rr, Gd^Ftp, Ke, Gs, Gs, Gs^Vda, Gs, Hh, Gs, Gs, Hh, Wwf, Wwf, Wwf, Hh, Gs, Gs, Hh, Gs, Gs^Vda, Gs, Gs, Ke, Gd^Ftp, Rr, Gd, Hhd, Mm, Gd, Gs, Wwf, Wwt, Dd^Ftp, Dd^Ftp
Dd^Ftp, Dd^Ftp, Wwf, Wwf, Wwf, Gs, Gs, Gd, Gd^Efm, Gd, Gd, Gd, Gd, Gd, Gd, Gd, Gs, Gs^Tf, Gs^Ftp, Wwf, Wwt, Wwt, Wwt, Wwf, Gs^Ftp, Gs^Tf, Gs, Gd, Gd, Gd, Gd, Gd, Gd, Gd^Efm, Gd, Gd, Gs, Gs, Wwf, Wwf, Wwf, Dd^Ftp, Hd^Ftp
Wwf, Wwf, Gs, Dd^Ftd, Wwf, Wwf, Hh^Ftp, Gd, Gd, Gd, Hhd, Gd, Gd, Gd, Gd, Gd, Gs, Hh, Wwf, Wwf, Wwt^Wkf, Ww^Ewf, Wwt^Wkf, Wwf, Wwf, Hh, Gs, Gd, Gd, Gd, Gd, Gd, Hhd, Gd, Gd, Gd, Hh^Ftp, Wwf, Wwf, Dd^Ftp, Gs^Efm, Wwf, Wwf
Rd, Rd, Gd, Gs^Vda, Wwf, Hh, Mm, Gd^Ftp, Gd^Tf, Gd, Gs^Vda, Gs, Gs, Gd, Gd, Gs^Efm, Ss, Wwf, Ww^Ewf, Ww^Ewf, Wwt, Wwt, Wwt, Ww^Ewf, Ww^Ewf, Wwf, Ss, Gs, Gd, Gd, Gs, Gs, Gs^Vda, Gd, Gd^Tf, Gd^Ftp, Mm, Hh, Wwf, Gs^Vda, Gd, Gs, Re
Hhd, Gd, Gd^Ftp, Gs, Gs, Wwf, Wwf, Re, Rd, Rd, Rd, Wwf, Ke, Ce, Hh, Ss^Vhs, Wwf, Wwf, Wwt^Wkf, Wwt, Wwt, Km^Ebn, Wwt, Wwt, Wwt^Wkf, Wwf, Wwf, Ss^Vhs, Hh, Ce, Ke, Wwf, Re, Rd, Rd, Re, Wwf, Wwf, Gs, Gs, Gd^Ftp, Rd, Gd
Re^Tf, Rd, Mm, Gd^Ftp, Gd, Gs, Wwt, Hh, Gd, Gd^Efm, Rd, Re, Ce, Mm, Mm^Xm, Wwf, Gs, Wwf, Wwf, Ww^Ewf, Ww^Ewf, Wwt, Ww^Ewf, Ww^Ewf, Wwf, Wwf, Gs, Wwf, Mm^Xm, Mm, Ce, Re, Rd, Gd, Gd, Hh, Wwt, Gs, Gd, Gd^Ftp, Mm, Rd, Hd
Re^Ftp, Rd, Rd, Hhd, Gs, Gs, Wwt, Gs^Ftd, Gd, Gd, Rd, Hh, Mm, Ce, Wwf, Wwf, Mm^Xm, Gs^Ftd, Wwf, Wwt, Wwt, Wwt^Wkf, Wwt, Wwt, Wwf, Gs^Ftd, Mm^Xm, Wwf, Wwf, Ce, Mm, Hh, Rd, Gd, Gd^Efm, Gs^Ftd, Wwt, Gs, Gs, Hhd, Rd, Rd, Rd
Dd^Ftp, Dd^Ftp, Dd^Ftp, Gd, Gs, Wwt, Gs, Hh, Gd, Rd, Re, Gs, Wwf, Wwf, Gs^Tf, Gs, Ke, Ce, Hh, Wwf, Wwf, Wwt, Wwf, Wwf, Hh, Ce, Ke, Gs, Gs^Tf, Wwf, Wwf, Gs, Re, Rd, Gd, Hh, Gs, Wwt, Gs, Rd, Dd^Ftp, Dd^Ftp, Dd^Ftd
Mdd, Hd, Rd^Tf, Gd, Gs, Wwf, Wwf, Gs, Gs, Gs, Wwf, Wwf, Ss, Wwf, Gs^Ftd, Gs, Gs, Mm^Xm, Wwf, Wwf, Wwf, Wwf, Wwf, Wwf, Wwf, Mm^Xm, Gs, Gs, Gs^Ftd, Wwf, Ss, Wwf, Wwf, Gs, Gs, Gs, Wwf, Wwf, Gs, Gd, Rd^Tf, Hd, Mdd
Dd^Ftp, Dd^Ftp, Rd, Rd, Rd, Gs^Vda, Gs, Wwt, Wwt, Wwt, Wwt, Gs, Ss, Gs^Efm, Ss, Gs, Wwf, Wwf, Ds, Dd^Ftd, Gs, Gs^Efm, Gs, Dd^Ftd, Ds^Ewsh, Wwf, Wwf, Gs, Ss, Gs^Efm, Ss, Gs, Wwt, Wwt, Wwt, Wwt, Gs, Gs^Vda, Rd, Rd, Rd, Dd^Ftd, Dd^Ftd
Mdd, Mdd, Dd^Ftp, Mm, Gd, Rd, Gs, Gs, Gs, Gs^Ftd, Wwt, Gs^Ftd, Mm, Ss, Gs^Ftd, Ss^Vhs, Wwf, Wwf, Ds, Gs^Efm, Hh, Gs, Hh, Gs, Ds^Efm, Wwf, Wwf, Ss^Vhs, Gs^Ftd, Ss, Mm, Gs^Ftd, Wwt, Gs^Ftd, Gs, Gs^Efm, Gs, Rd, Gd, Mm, Hd^Ftd, Mdd, Mdd
Mdd, Mdd, Hd, Mm, Gd, Gd^Tf, Gd, Gs, Gs, Wwt, Hh, Hh, Hh, Gs^Ftd, Wwf, Wwf, Wwf, Wwf, Mm^Xm, Hh, Mm^Xm, Hh, Mm^Xm, Hh, Mm^Xm, Wwf, Wwf, Wwf, Wwf, Gs^Ftd, Hh, Hh, Hh, Wwt, Gs, Gs, Gd, Rd^Tf, Gd, Mm, Hd, Mdd, Mdd
Mdd, Mdd, Mdd, Hd, Hd, Gd, Gd, Gs, Gs, Wwf, Wwf, Hh, Mm, Wwf, Mm^Xm, Mm^Xm, Mm, Mm^Xm, Mm^Xm, Mm^Xm, Mm^Xm, Mm^Xm, Mm^Xm, Mm^Xm, Mm^Xm, Mm^Xm, Mm^Xm, Mm^Xm, Mm^Xm, Wwf, Mm, Hh, Wwf, Wwf, Gs, Gd, Gd, Gd, Hd, Hd, Mdd, Mdd, Mdd
Mdd, Mdd, Mdd, Mdd, Mdd, Hd, Gd, Gd, Gd, Gs, Gs, Wwf, Wwf, Wwf, Mm^Xm, Mm, Mm, Mm, Mm, Mm, Mm, Mm, Mm, Mm, Mm, Mm, Mm, Mm, Mm^Xm, Wwf, Wwf, Wwf, Gs, Gs, Gd, Gd, Hd, Hd, Mdd, Mdd, Mdd, Mdd, Mdd
