Xu          , Xu          , Xu          , Xu          , Xu          , Xu          , Xu          , Xu          , Xu          , Xu          , Xu          , Xu          , Xu          , Xu          , Xu          , Xu          , Xu          , Xu          , Xu          , Xu          , Xu          , Xu          , Xu          , Xu          , Xu          , Xu          , Xu          , Xu          , Xu          , Xu          , Xu          , Xu          , Xu          , Xu          , Xu          , Xu          , Xu          , Xu          , Xu          , Xu          , Xu          
Xu          , Xu          , Xu          , Xu          , Xu          , Xu          , Xu          , Xu          , Xu          , Xu          , Xu          , Xu          , Xu          , Xu          , Xu          , Xu          , Xu          , Xu          , Xu          , Xu          , Rb          , Xu          , Xu          , Xu          , Xu          , Xu          , Xu          , Xu          , Xu          , Xu          , Xu          , Xu          , Xu          , Xu          , Xu          , Xu          , Xu          , Xu          , Xu          , Xu          , Xu          
Xu          , Xu          , Xu          , Xu          , Xu          , Xu          , Ai          , Ai          , Ha^Fpa      , Aa^Fpa      , Aa          , Aa          , Wwf         , Ww^Ewl      , Wwf         , Wwf         , Gg          , Xu          , Gg          , Rb          , Uu^Vu       , Rb          , Rb          , Uh          , Rb          , Xu          , Ss          , Xu          , Xu          , Xu          , Xu          , Xu          , Xu          , Xu          , Xu          , Xu          , Xu          , Xu          , Xu          , Xu          , Xu          
Xu          , Xu          , Xu          , Xu          , Xu          , Ms^Xm       , Ha          , Wot         , Gg^Efm      , Gg^Efm      , Gg^Efm      , Gg^Efm      , Hh^Fds      , Wwf         , Rp          , Rp          , Rp          , Hh          , Gg          , Rb          , Rb          , Rb          , Rb          , Rb          , Wwg         , Wwf         , Rb          , Ss          , Wwf         , Wwf         , Wwf         , Wwf         , Wwf         , Sm          , Wwg         , Xu          , Xu          , Xu          , Xu          , Xu          , Xu          
Xu          , Xu          , Xu          , Xu          , Mm^Xm       , Ms^Xm       , Gg^Efm      , Wwt         , Gg^Efm      , Gg^Efm      , Gg^Efm      , Gg^Efm      , Ch          , Wwf         , Rp          , Dd^Dc       , Gg          , Hh^Fds      , Rp          , Gg          , Rp          , Md          , Rb          , Rb          , Rp          , Rb          , Rb          , Rb          , Rb          , Rb          , Rb          , Uh          , Rb          , Rb          , Wwg         , Rb          , Rb          , Xu          , Xu          , Xu          , Xu          
Xu          , Xu          , Xu          , Xu          , Qxe         , Md          , Gg^Efm      , Wwt         , Wwt         , Gg^Efm      , Rp          , Rp          , Rp          , Rp          , Gg          , Gg          , Gs          , Rp          , Hh          , Rp          , Gs          , Rp          , Rp          , Rp          , 1 Kud       , Rp          , Rp          , Gd^Fdf      , Rp          , Rb          , Rb          , Md          , Rb          , Wwf         , Wwg         , Sm          , Wwf         , Gs^Ft       , Xu          , Xu          , Xu          
Xu          , Xu          , Xu          , Xu          , Qxe         , Md          , Gg^Efm      , Gg^Efm      , Wwf         , Gg          , Rrc^Vhca    , Gg          , Gs^Fds      , Mm^Xm       , Wwg         , Gs          , Gd          , Gs          , Gs          , Gs          , Gs          , Gs^Fms      , Gd          , Gs          , Cud         , Gd          , Gd          , Rp          , Hhd         , Rp          , Rp          , Rb          , Rb          , Wwf         , Wwf         , Wwg         , Wwf         , Gs          , Gs^Ft       , Xu          , Xu          
Xu          , Xu          , Xu          , Xu          , Xu          , Gg^Efm      , Hh          , Gg^Efm      , Wwt         , Gg          , Gg          , Gg          , Mm^Xm       , Mm^Xm       , Hh^Fds      , Wwf         , Gd          , Gd          , Ce          , Ke          , Re^Dr       , Re          , Re          , Gs          , Hhd         , Cud         , Cud         , Gd          , Gd          , Gd^Fdf      , Gd^Fdf      , Rp          , Hhd^Fmf     , Dd          , Wwf         , Ww^Vm       , Ds          , Re          , Wwf         , Xu          , Xu          
Xu          , Xu          , Xu          , Xu          , Xu          , Rb          , Gg          , Gs^Fds      , Wwf         , Gg          , Wwf         , Ss          , Mm^Xm       , Md          , Wwf         , Wwf         , Re          , Mm          , Ce          , Rd          , Rd          , Rd          , Rd          , Re          , Uh          , Mm^Xm       , Cud         , Gd          , Gd^Fdf      , Gd          , Gd^Fdf      , Rp          , Rp          , Dd          , Wwf         , Wwf         , Wwg         , Wwf         , Gs          , Xu          , Xu          
Xu          , Xu          , Xu          , Xu          , Xu          , Xu          , Gg          , Gg          , Wwf         , Gg          , Wwf         , Mm^Xm       , Mm          , Hh          , Wwf         , Gll^Fp      , Re          , Ke          , Dd          , Dd          , Rd          , Rd          , Dd          , Rd          , Rd          , Hhd         , Rd          , Re          , Ce          , Re          , Re          , Rp          , Rb          , Hhd         , Wwf         , Uh          , Wwf         , Gs^Ft       , Wwf         , Xu          , Xu          
Xu          , Xu          , Xu          , Xu          , Xu          , Ds          , Wwf         , Wwt         , Gg          , Gg          , Wwf         , Mm^Xm       , Wwf         , Wwf         , Wwf         , Gll         , Re          , Rd          , Dd          , Qxe         , Rd          , Rd          , Cdr         , Kd          , Rd          , Rd          , Re          , Re          , Re          , Re          , Re          , Rp^Vhcr     , Wwf         , Wwf         , Rb          , Wwg         , Gg^Efm      , Ww^Ewf      , Mm^Xm       , Wwf         , Xu          
Xu          , Xu          , Xu          , Xu          , Wwf         , Wwf         , Gs          , Gs          , Gs          , Gs          , Gs          , Wwf         , Wwf         , Ss^Vhs      , Wwf         , Wwf         , Wwf         , Rd          , Rd          , Ce          , Rd          , Dd          , Dd          , Md          , Gd          , Re          , Re          , Gd^Fdf      , Ke          , Re          , Sm          , Rb          , Wwf         , Rb          , Wwg         , Wwf         , Wwf         , Mm^Xm       , Mm^Xm       , Xu          , Xu          
Xu          , Xu          , Xu          , Xu          , Gll         , Gd          , Ce          , Gs          , Gs          , Hh^Fds      , Gs          , Wwf         , Wwf         , Wwf         , Ur          , Ur          , Uu^Tf       , Wwf         , Sm          , Rd          , Uue         , Uue         , Mm^Xm       , Md          , Mm^Xm       , Wog         , Re          , Ce          , Re          , Re          , Rb          , Wwg         , Gs^Fds      , Wwf         , Gg          , Cv          , Wwf         , Mm^Xm       , Mm^Xm       , Xu          , Xu          
Xu          , Xu          , Xu          , Xu          , Dd          , Ke          , Gd          , Wwg         , Gll         , Hh^Vhh      , Gd          , Gs          , Uh          , Sm          , Mm^Xm       , Mm^Xm       , Rb          , Wwf         , Rb          , Re          , Uh          , Mm^Xm       , Mm^Xm       , Mm^Xm       , Re^Dr       , Re          , Re^Vct      , Re          , Dd          , Mm^Xm       , Rb          , Wwf         , Gg^Ve       , Gg^Efm      , Wwrg        , Kv          , Gg          , Wwf         , Mm          , Wwf         , Xu          
Xu          , Xu          , Xu          , Xu          , Xu          , Gd          , Gll         , Gd          , Gll         , Gll         , Dd          , Md          , Ur          , Ur          , Uh          , Rb          , Wwg         , Wog         , Wwf         , Wwf         , Khw         , Mm^Xm       , Mm^Xm       , Rb          , Re          , Re          , Wwf         , Wwf         , Wwg         , Wwf         , Wwf         , Wwf         , Wwg         , Wwf         , Uu          , Wwf         , Wwg         , Wwf         , Wwf         , Wwf         , Xu          
Xu          , Xu          , Xu          , Xu          , Sm          , Gll^Fp      , Gll         , Gll         , Gll         , Sm          , Gd          , Gs^Ft       , Ur          , Ai          , Mm^Xm       , Wwf         , Uh          , Re^Vct      , Rb          , Wwf         , Chw         , Uu          , Mm^Xm       , Uu^Tf       , Uue         , Gs^Ft       , Ww^Ewf      , Sm          , Rb          , Rb          , Wwf         , Mm^Xm       , Wwf         , Rb          , Qxe         , Uu          , Gd^Fetd     , Hhd^Fdw     , Rb          , Rb          , Xu          
Xu          , Xu          , Xu          , Gd          , Gd          , Gd          , Gll         , Wog         , Gll         , Gll         , Gd          , Gs          , Uu^Tf       , Mm^Xm       , Uue         , Wwf         , Uu          , Wwf         , Qxe         , Wwf         , Uu^Tf       , Sm          , Sm          , Uh          , Uh          , Ds          , Ds          , Wwf         , Sm          , Wwf         , Wwg         , Wwg         , Rb          , Rb          , Rb          , Rb          , Gd          , Re          , Re          , Rd          , Xu          
Xu          , Xu          , Xu          , Gs          , Gll^Fp      , Gd          , Hh^Fp       , Gll         , Gll^Fp      , Hh          , Re          , Re          , Chs         , Mm^Xm       , Qxe         , Wwf         , Wwf         , Uu^Tf       , Mm^Xm       , Wwf         , Wwg         , Wwf         , Wwg         , Wwf         , Wwg         , Mm^Xm       , Wwf         , Wwg         , Wwf         , Wwf         , Chr         , Rb          , Re          , Re          , Gd          , Hhd         , Gd          , Gd          , Dd          , Xu          , Xu          
Xu          , Xu          , Ur          , Gd          , Gs          , Gd          , Gd          , Mm          , Hh          , Hh^Fp       , Re          , Rb          , Rb          , Ss          , Wwg         , Wwf         , Rb^Dr       , Wwrg        , Rb          , Uh          , Wog         , Sm          , Rb          , Sm          , Rb^Dr       , Wwf         , Wwg         , Ds          , Rb          , Rb          , Re          , Re          , Hh          , Gd          , Gd          , Dd^Dc       , Gs          , Uu^Tf       , Ur          , Xu          , Xu          
Xu          , Xu          , Dd          , Uu^Tf       , Gd          , Dd^Dc       , Gd          , Gd          , Re          , Re          , Chr         , Rb          , Wwf         , Ds          , Wwf         , Wwf         , Wwg         , Sm          , Wwg         , Sm          , Wwg         , Uh          , Mm^Xm       , Wwrg        , Wwf         , Wwf         , Qxe         , Ss          , Chs         , Rb          , Re          , Hh^Fp       , Gll^Fp      , Mm          , Hh^Fp       , Gd          , Gll^Fp      , Gd          , Xu          , Xu          , Xu          
Xu          , Xu          , Re          , Gd          , Gd          , Hhd         , Rb          , Re          , Rb          , Rb          , Wwg         , Wwf         , Sm          , Wwg         , Ds          , Mm^Xm       , Uh          , Wwf         , Sm          , Wwf         , Uu^Tf       , Wwf         , Qxe         , Uu^Tf       , Uu          , Wwf         , Uue         , Mm^Xm       , Uu^Tf       , Re          , Gd          , Hh          , Gll         , Gll         , Gll         , Gd          , Gd          , Gs          , Xu          , Xu          , Xu          
Xu          , Rd          , Rb          , Re          , Gd^Fetd     , Rb          , Qxe         , Rb          , Wwf         , Wwg         , Wwf         , Wwf         , Rb          , Wwf         , Ww^Ewf      , Ds          , Uue         , Uh          , Mm^Xm       , Sm          , Chw         , Wwf         , Rb          , Wwf         , Uh          , Wwf         , Mm^Xm       , Mm^Xm       , Ur          , Gs          , Gd          , Gll         , Gll         , Wog         , Gll         , Gd          , Sm          , Gd          , Xu          , Xu          , Xu          
Xu          , Rb          , Wwf         , Hhd^Fdw     , Wwg         , Uu          , Uu          , Rb          , Wwg         , Mm^Xm       , Wwf         , Rb          , Wwg         , Sm          , Wwf         , Gs^Ft       , Re          , Uu^Tf       , Mm^Xm       , Uu          , Khw         , Wwf         , Wwf         , Re^Vct      , Wwg         , Wwf         , Uh          , Ai          , Ur          , Gs^Ft       , Dd          , Sm          , Gll         , Gll         , Gll         , Gll^Fp      , Xu          , Xu          , Xu          , Xu          , Xu          
Xu          , Wwf         , Md          , Wwf         , Gg          , Wwf         , Wwrg        , Wwf         , Gg^Ve       , Wwf         , Rb          , Wwf         , Dd          , Wwf         , Re^Vct      , Re          , Re^Dr       , Rb          , Mm^Xm       , Mm^Xm       , Uh          , Wwf         , Rb          , Wog         , Rb          , Rb          , Mm^Xm       , Ur          , Uh          , Md          , Gd          , Gll         , Gg          , Gll         , Gd          , Gd          , Dd          , Xu          , Xu          , Xu          , Xu          
Xu          , Wwf         , Mm^Xm       , Gg          , Gg          , Kv          , Gg          , Gg^Efm      , Gs^Fds      , Wwf         , Rb          , Mm^Xm       , Re          , Re          , Re          , Re          , Mm^Xm       , Mm^Xm       , Mm^Xm       , Mm^Xm       , Uue         , Re          , Sm          , Wwf         , Uu^Tf       , Mm^Xm       , Ur          , Sm          , Wwf         , Gs          , Gs          , Hh^Vhh      , Gs          , Wwg         , Ce          , Ke          , Gll         , Xu          , Xu          , Xu          , Xu          
Xu          , Xu          , Mm^Xm       , Mm^Xm       , Gg          , Cv          , Wwg         , Wwf         , Wwf         , Wwg         , Sm          , Re          , Ke          , Ce          , Re          , Wog         , Gd          , Md          , Dd          , Uue         , Rd          , Rd          , Rd          , Wwf         , Wwf         , Ur          , Wwf         , Wwf         , Wwf         , Wwf         , Gs          , Hh^Fds      , Gs          , Gs          , Gs          , Gd          , Wwf         , Xu          , Xu          , Xu          , Xu          
Xu          , Xu          , Mm^Xm       , Mm^Xm       , Gg^Efm      , Wwf         , Rb          , Rb          , Wwf         , Rb          , Re          , Re          , Re          , Gd^Fdf      , Re          , Re          , Rd          , Md          , Cdr         , Dd          , Rd          , Ce          , Dd          , Rd          , Re          , Wwf         , Wwf         , Ss^Vhs      , Wwf         , Wwf         , Wwf         , Gs          , Gg          , Gs          , Wwf         , Wwf         , Xu          , Xu          , Xu          , Xu          , Xu          
Xu          , Wwf         , Wwf         , Ww^Ewf      , Wwf         , Wwg         , Wwf         , Wwf         , Rb          , Rp^Vhcr     , Re          , Re          , Ce          , Re          , Rd          , Rd          , Rd          , Kd          , Dd          , Rd          , Rd          , Qxe         , Dd          , Rd          , Re          , Gll         , Wwf         , Wwf         , Mm          , Mm^Xm       , Wwf         , Gg          , Wwf         , Wwt         , Gg          , Ds          , Xu          , Xu          , Xu          , Xu          , Xu          
Xu          , Xu          , Gs          , Gs^Ft       , Wwf         , Uh          , Wwf         , Hhd         , Rp          , Rp          , Gd^Fdf      , Re          , Gd^Fdf      , Re          , Cud         , Hhd         , Uh          , Rd          , Rd          , Rd          , Rd          , Dd          , Ce          , Ke          , Re          , Gll^Fp      , Wwf         , Hh          , Mm^Xm       , Mm^Xm       , Wwf         , Gg          , Wwf         , Gg          , Gg          , Xu          , Xu          , Xu          , Xu          , Xu          , Xu          
Xu          , Xu          , Wwf         , Wwf         , Ds          , Wwf         , Wwf         , Dd          , Hhd^Fmf     , Rp          , Gd^Fdf      , Gd          , Gd          , Gd          , Cud         , Mm^Xm       , Hhd         , Re          , Re          , Rd          , Re^Dr       , Rd          , Ce          , Md          , Gd          , Wwf         , Hh^Fds      , Md          , Mm^Xm       , Ss          , Gg          , Gg          , Wwt         , Gs^Fds      , Hh          , Rb          , Xu          , Xu          , Xu          , Xu          , Xu          
Xu          , Xu          , Gs^Ft       , Re          , Wwf         , Ww^Vm       , Wwf         , Dd          , Rb          , Rp          , Rp          , Gd^Fdf      , Hhd         , Gd          , Gd          , Cud         , Cud         , Gs          , Gd          , Re          , Gs          , Ke          , Gs          , Gd          , Gd          , Wwf         , Wwg         , Mm^Xm       , Gs^Fds      , Gg          , Rrc^Vhca    , Gg          , Wwf         , Gg^Efm      , Gg^Efm      , Gg^Efm      , Qxe         , Xu          , Xu          , Xu          , Xu          
Xu          , Xu          , Xu          , Gs          , Wwf         , Wwg         , Wwg         , Wwf         , Rb          , Rb          , Rb          , Rp          , Rp          , Rp          , Rp          , Gd          , 2 Kud       , Gd          , Rp          , Gs^Fms      , Gs          , Gs          , Hh          , Gs          , Gs          , Gs          , Gg          , Mm^Xm       , Rp          , Gg          , Rp          , Gg          , Wwt         , Gg^Efm      , Gg^Efm      , Md          , Qxe         , Xu          , Xu          , Xu          , Xu          
Xu          , Xu          , Xu          , Gs^Ft       , Rb          , Sm          , Wwg         , Wwf         , Rb          , Md          , Rb          , Rb          , Rb          , Gd^Fdf      , Rb          , Rp          , Rp          , Rp          , Rb          , Rp          , Rp          , Rp          , Rp          , Rp          , Gg          , Gg          , Rp          , Rp          , Ch          , Rp          , Gg^Efm      , Gg^Efm      , Gg^Efm      , Wwt         , Gg^Efm      , Md          , Mm^Xm       , Xu          , Xu          , Xu          , Xu          
Xu          , Xu          , Xu          , Xu          , Xu          , Rb          , Wwg         , Rb          , Wwf         , Uh          , Wwf         , Rb          , Wwf         , Rb          , Rb          , Rb          , Wwg         , Rb          , Rb          , Md          , Rb          , Gg          , Gg          , Hh^Fds      , Rp          , Dd^Dc       , Rp          , Wwf         , Hh^Fds      , Gg          , Gg^Efm      , Gg^Efm      , Gg^Efm      , Wwt         , Ha          , Ms^Xm       , Xu          , Xu          , Xu          , Xu          , Xu          
Xu          , Xu          , Xu          , Xu          , Xu          , Xu          , Xu          , Sm          , Xu          , Wwf         , Xu          , Wwf         , Xu          , Ss          , Ss          , Wwf         , Rb          , Rb          , Rb          , Rb          , Uu^Vu       , Rb          , Gg          , Hh          , Gg          , Rp          , Wwf         , Wwf         , Wwg         , Gg          , Aa          , Gg^Efm      , Ha^Fpa      , Wot         , Ai          , Ms^Xm       , Xu          , Xu          , Xu          , Xu          , Xu          
Xu          , Xu          , Xu          , Xu          , Xu          , Xu          , Xu          , Xu          , Xu          , Xu          , Xu          , Xu          , Xu          , Xu          , Xu          , Xu          , Xu          , Uh          , Xu          , Rb          , Rb          , Rb          , Xu          , Xu          , Xu          , Wwf         , Xu          , Ww^Ewl      , Xu          , Aa          , Xu          , Aa^Fpa      , Xu          , Ai          , Xu          , Xu          , Xu          , Xu          , Xu          , Xu          , Xu          
Xu          , Xu          , Xu          , Xu          , Xu          , Xu          , Xu          , Xu          , Xu          , Xu          , Xu          , Xu          , Xu          , Xu          , Xu          , Xu          , Xu          , Xu          , Xu          , Xu          , Xu          , Xu          , Xu          , Xu          , Xu          , Xu          , Xu          , Xu          , Xu          , Xu          , Xu          , Xu          , Xu          , Xu          , Xu          , Xu          , Xu          , Xu          , Xu          , Xu          , Xu          
Xu          , Xu          , Xu          , Xu          , Xu          , Xu          , Xu          , Xu          , Xu          , Xu          , Xu          , Xu          , Xu          , Xu          , Xu          , Xu          , Xu          , Xu          , Xu          , Xu          , Xu          , Xu          , Xu          , Xu          , Xu          , Xu          , Xu          , Xu          , Xu          , Xu          , Xu          , Xu          , Xu          , Xu          , Xu          , Xu          , Xu          , Xu          , Xu          , Xu          , Xu          
