border_size=1
usage=map

_s          , _s          , _s          , _s          , _s          , _s          , _s          , _s          , _s          , _s          , _s          , _s          , _s          , _s          , _s          , _s          , _s          , _s          , _s          , _s          , _s          , _s          , _s          , _s          , _s          , _s          , _s          
Gd          , Gd          , Gd          , Gd          , Gs          , Gs          , Gs          , Gs^Fmw      , Hh^Fms      , Wwf         , Gs^Fms      , Hh          , Ce          , 1 Ke        , Ce          , Mm          , Hh^Fds      , Wwf         , Gs          , Gs          , Gs^Fms      , Hh^Fp       , Gd          , Gs          , Gs          , Hh          , Gll^Tf      
Gll^Gvs     , Gs          , Gs          , Gs          , Hh          , Gd          , Gs          , Gd          , Wwf         , Wwf         , Gll^Gvs     , Ce          , Gs          , Ce          , Gd          , Ce          , Hh          , Wwf         , Wwf         , Gs          , Gd          , Gd          , Gd          , Gs          , Gll^Gvs     , Gll^Tf      , Hh^Fds      
Gll^Gvs     , Gll^Gvs     , Gs^Vl       , Gs^Fmw      , Gs^Fdw      , Mm          , Wwf         , Wwf         , Gs^Vc       , Gll^Gvs     , Gll^Gvs     , Gll^Gvs     , Gs          , Gs          , Gs          , Gs          , Gll^Gvs     , Gs          , Gs          , Wwf         , Wwf         , Gs          , Hh^Fmw      , Gs^Vh       , Gll^Gvs     , Gll^Gvs     , Gs^Fms      
Gll^Gvs     , Gll^Gvs     , Gd          , Gs          , Wwf         , Wwf         , Gll^Gvs     , Wwf         , Wwf         , Hh^Fp       , Gs          , Gs          , Gd          , Gs^Wm       , Gs^Fms      , Gll^Gvs     , Gll^Gvs     , Gs^Vl       , Wwf         , Wwf         , Gll^Tf      , Wwf         , Wwf         , Gs^Fp       , Gll^Gvs     , Gll^Gvs     , Gs^Fds      
Hh          , Gs^Wm       , Wwf         , Wwf         , Gd          , Gll^Gvs     , Gll^Gvs     , Gll^Gvs     , Gs^Fmw      , Wwf         , Wwf         , Gll^Tf      , Hh          , Gd          , Gs          , Gll^Gvs     , Wwf         , Wwf         , Gll^Gvs     , Gll^Gvs     , Gll^Gvs     , Gs          , Gs^Fmw      , Wwf         , Wwf         , Gs^Wm       , Hh          
Wwf         , Wwf         , Wwf         , Gll^Tf      , Gd          , Gll^Gvs     , Gll^Gvs     , Hh          , Hh^Fds      , Gs^Fds      , Wwf         , Wwf         , Wwf         , Ce          , Wwf         , Wwf         , Wwf         , Gs^Fds      , Gll^Gvs     , Gll^Gvs     , Gd          , Gd          , Hh          , Mm          , Wwf         , Wwf         , Wwf         
Gs^Fms      , Gs^Fds      , Gs          , Wwf         , Wwf         , Ce          , Ke          , Ce          , Wwf         , Wwf         , Gs          , Mm          , Hh^Fp       , Wwf         , Gll^Gvs     , Gll^Gvs     , Gll^Gvs     , Wwf         , Wwf         , Ce          , Ke          , Ce          , Wwf         , Wwf         , Gll^Gvs     , Gll^Gvs     , Gll^Gvs     
Gll^Gvs     , Gs          , Gd          , Gs          , Wwf         , Wwf         , Wog^Bw|     , Wwf         , Wwg         , Gs          , Gs          , Gs          , Gs^Fds      , Gs^Fms      , Gll^Gvs     , Gll^Gvs     , Gll^Gvs     , Gll^Gvs     , Gs^Wm       , Wwf         , Wwg         , Wwf         , Wwf         , Gs^Vhs      , Gll^Gvs     , Gll^Gvs     , Gd          
Gll^Gvs     , Gll^Gvs     , Gs^Vh       , Hh^Fmw      , Gs^Fms      , Wwg         , Wog^Bw|     , Wwg         , Gll^Tf      , Gd          , Ce          , Gs          , Gd          , Gd          , Gd          , Gs^Vc       , Gll^Gvs     , Gll^Gvs     , Gs^Fmw      , Gs^Fdw      , Wwg         , Wwf         , Gs^Fp       , Gs^Fms      , Gll^Tf      , Gs^Wm       , Gd          
Wwf         , Gll^Gvs     , Gs^Wm       , Hh^Tf       , Wwg         , Wwg         , Wog^Bw|     , Wwg         , Wwg         , Gs          , Gs          , Gs          , Gs^Fmw      , Gs          , Gs          , Gs          , Gs          , Gs          , Hh          , Mm          , Wwg         , Wwf         , Wwf         , Hh          , Gs          , Gd          , Gd          
Mm          , Wwf         , Wwf         , Wwf         , Wwf         , Mm          , Hh          , Wog^Bw\     , Wog^Bw\     , Gs^Fp       , Gs          , Hh          , Hh^Fdw      , Gs          , Gd          , Gs          , Gll^Tf      , Gd          , Wwf         , Wwf         , Gs^Fdw      , Wwf         , Wwf         , Gs          , Gs          , Gd          , Gs          
Hh^Fp       , Hh          , Gs          , Gs          , Wwf         , Hh^Fds      , Gs^Wm       , Wwg         , Wwg         , Wog^Bw\     , Gs          , Gd          , Gll^Gvs     , Gll^Gvs     , Gll^Gvs     , Gd          , Gs          , Wwf         , Wwf         , Wwf         , Gd          , Ce          , Wwf         , Gs          , Gs          , Gs          , Gs^Fdw      
Gs^Fms      , Gs^Fdw      , Gd          , Gs          , Wwf         , Gd          , Gd          , Gs          , Wwf         , Wwf         , Gd          , Gll^Gvs     , Gll^Gvs     , Gs^Wm       , Gll^Gvs     , Gll^Gvs     , Gs          , Wwf         , Wwg         , Gd          , Gs^Wm       , Gs          , Wwf         , Gs          , Gd          , Gs^Fmw      , Hh^Fdw      
Gs          , Gd          , Gd          , Gd          , Wwf         , Ce          , Gs^Fms      , Wwf         , Wwf         , Wwf         , Gll^Tf      , Gd          , Gd          , Gll^Gvs     , Hh^Fds      , Gd          , Gs          , Wog^Bw\     , Wog^Bw\     , Wwg         , Hh          , Hh^Fp       , Wwf         , Gd          , Wwf         , Hh          , Mm          
Gs          , Gs          , Gs          , Gs          , Wwf         , Wwf         , Wwg         , Wwf         , Hh          , Gd          , Gd          , Gd          , Gd          , Gd          , Gs^Fp       , Hh          , Gs          , Gs^Fms      , Wwg         , Wog^Bw\     , Wog^Bw|     , Mm          , Wwg         , Wwf         , Gll^Gvs     , Wwf         , Wwf         
Gs          , Gd          , Gll^Tf      , Hh          , Gs^Fmw      , Wwf         , Wwg         , Mm          , Gs^Fdw      , Gll^Gvs     , Gll^Gvs     , Gs          , Gd          , Gs          , Gd          , Gs          , Ce          , Gd          , Gll^Tf      , Wwg         , Wog^Bw|     , Wwg         , Gs^Fds      , Hh^Tf       , Gs^Vc       , Gll^Gvs     , Gll^Gvs     
Gs          , Gs^Wm       , Gll^Gvs     , Gs^Fdw      , Wwf         , Wwf         , Wwg         , Gs^Fp       , Gll^Gvs     , Gll^Gvs     , Gll^Gvs     , Gs^Vh       , Gs          , Gs          , Gs^Fmw      , Gs          , Gs          , Gd          , Wwg         , Wwg         , Wog^Bw|     , Wwg         , Wwf         , Hh^Fds      , Gd          , Gll^Gvs     , Gs          
Gll^Gvs     , Gll^Gvs     , Gll^Gvs     , Gs^Vl       , Wwf         , Wwf         , Ke          , Wwf         , Wwf         , Gll^Gvs     , Gll^Gvs     , Gll^Gvs     , Gs^Wm       , Gs^Fds      , Hh^Fdw      , Gs          , Gs          , Gs          , Wwf         , Wwf         , Ke          , Wwf         , Wwf         , Gd          , Gd          , Gs^Wm       , Gs^Fp       
Wwf         , Gll^Gvs     , Wwf         , Wwf         , Hh          , Ce          , Gll^Gvs     , Ce          , Gs          , Wwf         , Wwf         , Gll^Gvs     , Wwf         , Wwf         , Wwf         , Mm          , Wwf         , Wwf         , Hh^Fmw      , Ce          , Gll^Gvs     , Ce          , Gll^Gvs     , Wwf         , Wwf         , Gs^Fms      , Wwf         
Hh          , Wwf         , Wwf         , Mm          , Gs^Fmw      , Gll^Gvs     , Gll^Gvs     , Gll^Gvs     , Gs          , Gs^Fms      , Wwf         , Wwf         , Gs          , Ce          , Hh          , Wwf         , Wwf         , Gs^Fms      , Gs^Fp       , Hh          , Gll^Gvs     , Gll^Gvs     , Gll^Gvs     , Gll^Tf      , Wwf         , Wwf         , Hh          
Gs^Fdw      , Gs          , Gs          , Wwf         , Wwf         , Gll^Gvs     , Gll^Tf      , Gd          , Wwf         , Wwf         , Gll^Gvs     , Gs          , Gs^Fds      , Gs          , Gd          , Gll^Tf      , Gs          , Wwf         , Wwf         , Gd          , Gd          , Gll^Gvs     , Wwf         , Wwf         , Gll^Gvs     , Gll^Gvs     , Gll^Gvs     
Gs^Fmw      , Gd          , Gs          , Gs^Fds      , Hh^Fp       , Wwf         , Wwf         , Wwf         , Gll^Gvs     , Gs^Vhs      , Gll^Gvs     , Gs          , Gs          , Gs^Wm       , Gd          , Gd          , Gll^Gvs     , Hh^Fdw      , Gs^Vl       , Wwf         , Wwf         , Wwf         , Gs^Fdw      , Gll^Gvs     , Gs^Vh       , Gll^Gvs     , Gd          
Hh^Fds      , Gd          , Gs^Wm       , Gs^Vc       , Gll^Gvs     , Gs          , Gs          , Wwf         , Wwf         , Gll^Gvs     , Hh          , Gd          , Gd          , Gs          , Gs          , Gll^Gvs     , Gll^Gvs     , Gll^Gvs     , Wwf         , Wwf         , Gd          , Mm          , Hh          , Gs^Fmw      , Gs          , Gs^Wm       , Gd          
Gll^Tf      , Gll^Tf      , Gll^Gvs     , Gll^Gvs     , Gll^Gvs     , Gs          , Gs^Fdw      , Gs          , Gs          , Wwf         , Hh^Fms      , Ce          , Ce          , Ce          , Ce          , Ce          , Gs^Fms      , Wwf         , Hh^Fp       , Gs          , Gs          , Gd          , Gs          , Gs          , Gs          , Gd          , Gd          
_s          , Hh          , _s          , Gll^Gvs     , _s          , Hh^Fmw      , _s          , Gd          , _s          , Wwf         , _s          , Mm          , _s          , 2 Ke        , _s          , Hh          , _s          , Wwf         , _s          , Gs^Fds      , _s          , Gs          , _s          , Gd          , _s          , Gd          , _s          
_s          , _s          , _s          , _s          , _s          , _s          , _s          , _s          , _s          , _s          , _s          , _s          , _s          , _s          , _s          , _s          , _s          , _s          , _s          , _s          , _s          , _s          , _s          , _s          , _s          , _s          , _s          
