border_size=1
usage=map

_s          , _s          , _s          , _s          , _s          , _s          , _s          , _s          , _s          , _s          , _s          , _s          , _s          , _s          , _s          , _s          , _s          , _s          , _s          , _s          , _s          , _s          , _s          , _s          , _s          , _s          , _s          , _s          , _s          , _s          , _s          
_s          , _s          , Wo          , _s          , Hhd^Fdf     , _s          , Rb          , _s          , Sm          , _s          , Sm          , _s          , Hhd^Fdw     , _s          , Rd          , _s          , Hhd^Tf      , _s          , Rb^Fdf      , _s          , Re          , _s          , Rb^Es       , _s          , Rb^Fp       , _s          , Re          , _s          , Hhd^Fdf     , _s          , _s          
_s          , Wo          , 1 Khw       , Chw         , Rb^Es       , Rb^Es       , Rb^Fmf      , Sm^Vhs      , Rb          , Sm^Tf       , Re          , Hhd         , Rd          , Rd          , Rd          , Rd^Es       , Rd          , Rb^Fmf      , Sm^Vht      , Re^Es       , Rb^Es       , Rb          , Rb          , Rb^Es       , Rb          , Re          , Re          , Rb^Fmw      , Hhd         , Md          , _s          
_s          , Chw         , Chw         , Chw         , Wwf         , Wwg         , Wwg         , Wwf         , Wwf         , Rb          , Rb^Es       , Re          , Rb^Fdf      , Rd          , Rd^Es       , Rd          , Re          , Re^Es       , Rb          , Rb          , Wwf         , Wwg         , Wwg         , Wwf         , Wwf         , Rb          , Rb^Es       , Re^Es       , Re          , Hhd^Fmf     , _s          
_s          , Wwf^Fmw     , Wwf         , Wwf         , Wwf         , Wwf         , Wwf         , Wwg         , Wwf         , Wwg         , Wwg         , Rb          , Ko          , Co          , Hhd         , Re          , Rb          , Rb^Fp       , Wwg         , Wwg         , Wwf         , Wog         , Wwg         , Md          , Hhd         , Wwf         , Rb          , Re          , Re^Es       , Rb^Fdw      , _s          
_s          , Wwf         , Wwf         , Wwg         , Wwg         , Wwf         , Rb^Fdw      , Rb          , Rb          , Rb          , Hhd         , Wwg         , Wog^Bw|     , Co          , Hhd^Fp      , Rb^Es       , Wwf         , Wog^Bw\     , Rb          , Hhd^Fmw     , Rb^Fmw      , Wwf         , Rb          , Hhd^Fdw     , Rb^Vu       , Wwf         , Wwf         , Rb^Fp       , Uue^Tf      , Re^Es       , _s          
_s          , Wwf         , Rb          , Wwg         , Sm          , Wog^Vhs     , Re          , Re^Es       , Qxe         , Re          , Re          , Rb          , Rb          , Wwf         , Wwf         , Md          , Wwf         , Rb^Es       , Rb          , Rb^Es       , Rb^Es       , Rb          , Re          , Re          , Re          , Rb          , Wwf         , Uue^Em      , Uue^Em      , Sm          , _s          
_s          , Rb^Es       , Re          , Hhd         , Rb^Fmw      , Sm          , Re          , Rd          , Qxe^Bw/     , Rd^Es       , Rd          , Re          , Re^Es       , Rb          , Rb          , Wwf         , Wwf         , Rb^Fdw      , Rb^Vud      , Rb^Es       , Uh          , Rb          , Rb^Fmf      , Re          , Qxe^Bw|     , Rb^Es       , Wwf         , Rb^Fdf      , Rb          , Rb^Fmw      , _s          
_s          , Re          , Rd          , Rd          , Rd          , Re^Es       , Rd          , Rd          , Qxe         , Rd          , Rb^Fmf      , Rd          , Re          , Re          , Hhd^Fdw     , Rb          , Rb^Es       , Wwf         , Rb          , Rb          , Rb^Es       , Rb^Es       , Qxe         , Qxe         , Rd^Es       , Hhd^Tf      , Hhd         , Wwf         , Rb          , Re^Es       , _s          
_s          , Md          , Hhd^Fdf     , Rd          , Rd          , Rd          , Rd          , Rd          , Rb^Tf       , Qxe         , Re          , Rb^Vd       , Rb^Es       , Rb          , Rb          , Rb          , Wwf         , Wwf         , Wwf         , Uue^Emf     , Uue^Tf      , Re^Es       , Qxe^Bw\     , Rd^Es       , Re          , Md          , Wwf         , Wwf         , Rb^Es       , Re          , _s          
_s          , Sm          , Rb^Tf       , Re^Es       , Re          , Rd          , Ko          , Rd^Es       , Rd          , Qxe^Bw/     , Qxe         , Rb          , Wwf         , Wwf         , Wwf         , Wwf         , Uue^Tf      , Xue         , Wwg         , Xue         , Xue         , Re          , Re          , Rd          , Re          , Hhd^Fmw     , Wwf         , Hhd^Fdf     , Rb^Fmf      , Re          , _s          
_s          , Wwg         , Wwg         , Rb          , Rb          , Rb^Fdf      , Co          , Co          , Re          , Re          , Sm          , Hhd         , Rb          , Rb          , Rb^Es       , Rb          , Uue^Emf     , Xue         , Xue         , Wog         , Wwg         , Xue         , Rb          , Re^Es       , Sm          , Rb^Fdw      , Rb^Fmw      , Wwf         , Rb          , Re          , _s          
_s          , Wwf         , Wwf         , Wwg^Bw|     , Wwg         , Rb^Es       , Wwg         , Rb^Fp       , Rb          , Re          , Re          , Md          , Hhd^Fmw     , Re          , Re          , Re          , Rb^Fp       , Uue^Em      , Uue^Emf     , Xue         , Wwf         , Rb^Fdw      , Wwf         , Rb          , Rb          , Rb^Es       , Wwf         , Wwf         , Rb          , Rb^Tf       , _s          
_s          , Wwf         , Wwg         , Wog^Bw|     , Wog^Bw\     , Wog^Bw|     , Wog         , Wwg         , Wwg         , Rb^Es       , Rb^Es       , Re          , Rd          , Rd          , Rd          , Rd          , Rd          , Re          , Re          , Rb^Fmw      , Hhd^Vo      , Wwf         , Hhd^Fmf     , Wwf         , Wwg         , Rb^Es       , Wwg         , Rb^Es       , Rb^Vht      , Hhd         , _s          
_s          , Wwg         , Rb^Vht      , Wwg^Bw|     , Wwg         , Wwg^Bw|     , Wwg         , Wog         , Hhd^Fdf     , Wwf         , Hhd^Vo      , Re          , Re          , Rd^Es       , Rd          , Qxe         , Rd          , Rd          , Rd^Es       , Re          , Rb          , Wwf         , Wwg         , Wog         , Wog         , Wwg^Bw|     , Wog^Bw\     , Wwg^Bw|     , Wwg         , Wwg         , _s          
_s          , Hhd         , Rb          , Rb          , Wwf         , Rb          , Rb^Es       , Wwf         , Wwf         , Wwf         , Wwf         , Rb^Fdf      , Uue^Emf     , Re          , Rb^Fdw      , Rd          , Re          , Rd          , Hhd^Fp      , Re          , Re^Es       , Rb          , Rb          , Wwg         , Wwg         , Wog^Bw|     , Wwg         , Wog^Bw|     , Wwf         , Wwf         , _s          
_s          , Rb^Tf       , Rb          , Wwf         , Rb^Fmw      , Rb          , Sm          , Rb          , Rb^Es       , Rb^Fp       , Wwg         , Xue         , Xue         , Uue^Em      , Uue^Emf     , Re          , Rb          , Re^Es       , Rb          , Md          , Sm          , Re          , Re^Es       , Rb^Fmf      , Co          , Rb^Es       , Rb^Es       , Wwg^Bw|     , Wwg         , Wwf         , _s          
_s          , Re^Es       , Rb^Fdw      , Wwf         , Wwf         , Rb^Fdf      , Re          , Re          , Re          , Xue         , Xue         , Wog         , Wwg         , Xue         , Uue^Tf      , Rb          , Wwf         , Rb          , Wwf         , Hhd         , Qxe         , Re          , Rd          , Co          , Ko          , Rb^Fdf      , Re          , Rb          , Rb^Tf       , Wwg         , _s          
_s          , Re^Es       , Rb          , Hhd^Fdw     , Wwf         , Hhd^Fmw     , Re          , Rd          , Qxe^Bw\     , Re          , Uue^Tf      , Xue         , Wwf         , Xue         , Wwf         , Wwf         , Rb          , Wwf         , Rb^Es       , Rb          , Re          , Qxe^Bw/     , Rb^Tf       , Rd          , Rd          , Rd          , Rd          , Re          , Hhd^Fdw     , Sm          , _s          
_s          , Re          , Rb^Es       , Wwf         , Hhd         , Md          , Rd^Es       , Rd^Es       , Qxe         , Re          , Rb^Es       , Uue^Emf     , Rb^Es       , Wwf         , Rb^Es       , Rb          , Hhd^Fdf     , Rb          , Re          , Rb^Vd       , Rb^Fp       , Qxe         , Qxe         , Rd          , Rd          , Rd^Es       , Rd          , Rd          , Rd          , Md          , _s          
_s          , Re          , Rb          , Wwf         , Wwf         , Hhd^Tf      , Qxe^Bw|     , Qxe         , Rb^Fmf      , Rb          , Uh          , Rb          , Rb^Vud      , Wwf         , Wwf         , Rb          , Rb^Es       , Re          , Re          , Rd          , Rd          , Rd          , Qxe^Bw/     , Rd          , Re          , Re          , Rb^Fdw      , Rd          , Re          , Re^Es       , _s          
_s          , Rb^Fmf      , Uue^Em      , Rb^Fdf      , Wwf         , Rb^Es       , Re          , Re          , Re          , Rb          , Rb          , Rb          , Rb          , Rb^Fdw      , Wwf         , Wwf         , Wwf         , Rb          , Rb          , Re^Es       , Re^Es       , Rd          , Qxe         , Rd^Es       , Re          , Sm          , Sm          , Hhd         , Rb^Es       , Rb          , _s          
_s          , Sm          , Uue^Tf      , Uue^Em      , Wwf         , Rb          , Rb^Vu       , Re^Es       , Rb^Es       , Rb          , Rb^Fp       , Rb^Es       , Rb          , Rb          , Wwf         , Md          , Hhd^Fmf     , Wwf         , Wog^Bw|     , Rb^Es       , Hhd         , Re          , Rb          , Re          , Rb^Fmw      , Wog^Vhs     , Wwg         , Wwg         , Wwf         , Wwf         , _s          
_s          , Re^Es       , Re          , Rb^Fmw      , Rb          , Wwf         , Hhd         , Hhd^Fdf     , Wwg         , Wwf         , Wwf         , Hhd^Fp      , Wwg         , Wog^Bw\     , Rb          , Rb^Es       , Hhd         , Co          , Ko          , Wwg         , Wwg         , Rb          , Wwf         , Rb^Es       , Wwf         , Wwf         , Wwf         , Wwg         , Wwf         , Wwf         , _s          
_s          , Rb^Fp       , Re          , Re          , Rb^Es       , Wwf         , Wwf         , Md          , Wwg         , Wog         , Wwf         , Wwg         , Rb          , Rb^Fdf      , Re          , Re^Es       , Rd          , Co          , Rb^Fmf      , Rb^Es       , Rb          , Wwg         , Wwf         , Wwg         , Wwg         , Wwf         , Wwf         , Wwf         , Chw         , Wwf^Fdf     , _s          
_s          , Hhd^Fmf     , Hhd         , Re          , Re          , Rb          , Rb          , Wwf         , Rb          , Wwg         , Rb          , Rb          , Sm^Vht      , Re          , Rd^Es       , Rd          , Rd          , Rd          , Rd          , Re          , Re^Es       , Rb          , Rb          , Wwf         , Rb^Fdw      , Wwg         , Rb^Es       , Chw         , 2 Khw       , Chw         , _s          
_s          , Md          , Hhd^Fdw     , Rb^Fmf      , Re          , Re          , Rb^Fdw      , Rb^Es       , Rb          , Rb          , Re^Es       , Re^Es       , Rb^Fp       , Rb^Fmw      , Hhd^Tf      , Rd          , Rd          , Rd^Es       , Hhd^Fdf     , Hhd         , Sm          , Sm^Tf       , Sm          , Sm^Vhs      , Rb          , Rb^Es       , Hhd^Fp      , Chw         , Wo          , Wo          , _s          
_s          , _s          , _s          , _s          , _s          , _s          , _s          , _s          , _s          , _s          , _s          , _s          , _s          , _s          , _s          , _s          , _s          , _s          , _s          , _s          , _s          , _s          , _s          , _s          , _s          , _s          , _s          , _s          , _s          , _s          , _s          
