border_size=1
usage=map

Ms^Xo, Ms^Xo, Ms^Xo, Ms^Xo, Ms^Xo, Ms^Xo, Ms^Xo, Ms^Xo, Ms^Xo, Ms^Xo, Ha^Xo, Ms^Xo, Rp^Xo, Gd^Xo, Gd, Hhd, Hhd, Ms, Ms^Xm, Ms^Xm, Ms^Xm, Ms^Xm, Ms^Xm, Ha, Ai, Ms^Xm, Ms^Xm, Ms^Xm, Ms^Xm, Ms^Xm, Ms^Xm, Ms^Xm, Hhd, Mm, Md, Ms^Xm, Ms^Xm, Ms^Xm, Ms^Xm, Ms^Xm, Ms^Xm, Ms^Xm, Ms^Xm, Ms^Xm, Ms^Xm
Ms^Xo, Ms^Xo, Ms^Xo, Ms^Xo, Ms^Xo, Ms^Xo, Md^Xo, Md^Xo, Md^Xo, Ms^Xo, Ha^Xo, Aa^Xo, Rp, Gd^Xo, Khr, Gd^Xo, Hhd^Fdw, Hhd^Xo, Ha, Md^Xo, Ha, Ha^Xo, Hhd, Ha^Xo, Ai, Aa^Xo, Aa, Hhd^Xo, Gd^Fdw, Ha^Xo, Aa, Aa^Xo, Gd, Hhd^Xo, Gd^Fdw, Md^Xo, Md, Ms^Xo, Ms^Xm, Ms^Xo, Ms^Xm, Ms^Xo, Ms^Xm, Ms^Xo, Ai^Xo
Ms^Xo, Ms^Xo, Ms^Xo, Ms^Xo, Ms^Xo, Md^Xo, Md^Xo, Md^Xo, Hhd^Xo, Hhd^Xo, Ai^Xo, Aa, Rp, Chr^Dr, Gd^Em, Rd^Uf, Gd^Fdw, Gd, Gd, Hhd, Rd^Fdw, Hhd^Fetd, Hhd, Ai^Bw\r, Sm^Bw\r, Rd, Rd, Gd^Fdw, Ai, Aa, Rb, Gd, Rd^Uf, Gd, Gd, Gd^Fdw, Hhd, Ms, Ms^Xm, Ms^Xm, Ms^Xm, Ms^Xm, Ai^Xo, Ai^Xo, Ai^Xo
Ms^Xo, Ms^Xo, Md^Xo, Ms^Xo, Md^Xo, Md^Xo, Hhd^Xo, Hhd^Xo, Sm^Xo, Sm^Xo, Ai, Chr^Dr, Rd^Em, Rp, Rp, Gd, Chr^Edb, Chr^Edb, Rd, Rd, Khr, Rd, Sm, Sm, Chr, Sm^Bw\r, Sm^Bw\r, Rd, Sm, Rd, Rd, Hhd^Fdw, Md, Gd, Gd^Fetd, Md, Aa^Fdw, Ha, Ms, Ms^Xm, Ai^Xo, Ai^Xo, Ai^Xo, Ai^Xo, Ai^Xo
Ms^Xo, Md^Xo, Md^Xo, Md^Xo, Hhd^Xo, Hhd^Xo, Sm^Xo, Sm^Xo, Ai, Ai, Sm^Fdw, Rd, Chr^Edb, Gd^Fdw, Rp, Gd, Gd^Fdw, Rb^Dr, Rp, Rp, Gd^Es, Chr, Chr, Chr, Rd^Edb, Khr, Chr, Sm^Bw\r, Rd, Wwf^Es, Wwf^Es, Rd, Rd, Gd, Gd^Fdw, Hhd^Fdw, Gd, Aa^Fdw, Ha, Ms^Xm, Ai^Xo, Ai^Xo, Ai^Xo, Ai^Xo, Ai^Xo
Ms^Xo, Md^Xo, Hhd^Xo, Hhd^Xo, Md^Xo, Sm^Xo, Ai, Sm^Fdw, Sm, Sm^Fdw, Rd, Rd, Rd, Gd^Fdw, Rp, Rp, Rp, Rp, Gd^Es, Gd^Es, Gd, Gd, Gd, Rd, Gd, Rd^Edb, Rd, Chr, Rp, Rd, Rp, Wwf, Wwf^Bw/r, Rp, Rp, Rb^Dr, Gd, Ai, Khw, Ha, Ai, Ai^Xo, Ai^Xo, Ai^Xo, Ms^Xm
Ha^Xo, Hhd^Xo, Hhd^Xo, Hhd^Xo, Sm^Fdw, Sm, Sm, Sm^Bw\r, Ai^Bw\r, Rd, 2 Khr, Rp, Rp, Rp, Hhd, Hhd^Vhcr, Gd^Edb, Gd, Rd, Rd, Gd^Fdw, Gd, Rb, Gd, Gd^Fdw, Gd^Edt, Rd, Chr^Vhcr, Rd^Uf, Rp, Gd, Rp, Chr, Wwf, Rp, Gd, Hhd^Fdw, Chw, Wwrg, Wwg, Wog, Ai, Ms^Xm, Ms^Xm, Ms^Xm
Ms^Xo, Ha^Xo, Ai, Sm^Fdw, Ai, Ai, Sm^Fdw, Ai, Chr^Edt, Chr^Edt, Rd, Chr, Rp, Gd, Gd^Fdw, Hhd^Fdw, Gd, Rd, Chr^Edb, Ai, Md, Hhd^Fdw, Gd, Hhd, Gd, Gd, Hhd^Fdw, Mm^Xm, Gd^Edb, Gd, Gd, Hhd^Fdw, Rd, Wwf, Wwf, Rp, Wwg^Bw\r, Wwf, Wwf^Es, Wwg, Sm, Ai, Ms, Ms^Xm, Ms^Xm
Md, Ha, Sm, Sm^Bw\r, Sm^Bw\r, Sm, Khr, Chr, Rd, Rd, Gd^Fdw, Gd, Gd, Rp, Rp, Gd, Gd, Rd, Rb^Dr, Rd^Edb, Rd, Gd^Em, Gd, Gd, Gd, Md, Gd^Edt, Ai, Gd, Gd, Md, Gd^Fdw, Rd, Wwf, Wwf, Ai^Dr, Wwf^Es, Wog^Bw\r, Rp, Hhd^Uf, Md, Hhd^Fdw, Ha^Fdw, Ms^Xm, Ms^Xm
Ha, Hhd^Fdw, Hhd, Sm^Fdw, Gd^Fdw, Sm^Bw\r, Chr, Rd, Gd, Gd, Sm^Fdw, Rb^Dr, Gd, Gd, Gd^Edb, Rp, Rp, Gd, Rd, Rd^Edb, Wwf, Rd, Rb^Dr, Sm^Fdw, Gd, Gd^Edt, Rd, Gd, Rd, Ai, Rd, Rd, Wwf, Wwf, Wwf^Fdw, Wwf^Es, Wwf, Rd^Edb, Rp, Hhd, Gd^Fdw, Gd, Aa, Ha, Ha
Ha, Gd^Fetd, Hhd^Fdw, Hhd, Gd, Rb, Chr, Sm, Sm, Sm^Es, Rb, Gd, Rb, Gd^Edb, Gd^Fdw, Gd, Ai, Rp, Rp, Sm^Vhs, Hhd^Uf, Wwf, Wwf, Rd, Rd, Rd, Ai, Chr, Wwrg, Wwf, Wwf, Sm^Dr, Wwf, Wwf^Es, Wwg, Mm^Xm, Wwf^Es, Rd^Vd, Rd, Rp, Rp, Gd, Rb, Aa^Fdw, Aa^Fdw
Hhd, Gd, Gd, Gd, Rp, Rp, Khr, Rp, Rp, Wwf^Es, Rb^Dr, Gd, Gd, Gd, Rd^Uf, Md, Chr^Dr, Gd^Edb, Rp, Sm, Mm^Xm, Md, Wwf, Rd, Wwf^Es, Wwf, Wwg, Ai, Mm^Xm, Sm^Uf, Wwf, Wwf^Es, Rd, Rd, Hhd^Fdw, Wwrg, Wwf^Es, Gd^Fdw, Rd, Rb^Dr, Rp, Gd, Gd^Fdw, Gd, Hhd^Fdw
Md, Gd^Fdw, Gd^Fdw, Gd, Rp, Rb^Dr, Gd, Gd^Fetd, Rd, Wwf^Bw\r, Chr^Edt, Rb, Gd^Fdw, Gd, Gd, Gd^Fdw, Gd^Edb, Gd^Edb, Rp, Wog, Wwf^Es, Wwf, Ai, Wwf, Gd^Edb, Hhd^Uf, Wwrg, Mm^Xm, Wwf^Es, Wwf, Hhd^Fdw, Rd, Gd, Md, Rd^Fdw, Rd, Wwf^Es, Rd, Rd, Rp, Hhd^Fdw, Gd, Gd^Edb, Hhd^Fdw, Hhd
Md, Md, Hhd^Fdw, Gd, Rp, Gd, Gd^Edb, Gd^Edb, Rd, Wwf, Rd^Uf, Rp^Vd, Rp, Gd, Gd, Gd, Rp, Rp, Wwg, Wwf^Es, Wog, Rd^Uf, Rd, Gd^Fetd, Khr, Gd^Edb, Hhd^Fdw, Wwg, Wwf, Rp^Vd, Rd, Gd, Rd^Uf, Mm^Xm, Rd, Sm, Mm^Xm, Chr^Dr, Mm^Xm, Rp, Hhd^Vd, Rd, Gd^Edb, Gd, Gd
Md, Hhd, Gd, Gd, Rp, Gd, Md, Gd^Fdw, Hhd^Fdw, Wwf, Rd, Gd, Gd, Rp, Rp, Rp, Ai, Wog^Bw\r, Wwf^Bw\r, Wwf^Es, Wwf, Hhd, Mm^Xm, Rd^Edb, Wwf, Gd, Wwf^Bw\r, Sm, Ai, Chr^Edb, Rp, Gd, Gd, Gd, Rd, Wwf, Hhd^Fdw, Mm^Xm, Md, Rd^Uf, Rp, Rd^Edb, Gd, Gd, Md
Gd, Gd, Gd^Edb, Rd^Edb, Hhd^Vd, Rd^Uf, Mm^Xm, Mm^Xm, Mm^Xm, Wwf, Rd, Gd, Rd^Uf, Gd, Rd, Chr^Edb, Wwf, Sm, Hhd^Fdw, Gd, Khr, Rd^Edb, Rd, Hhd, Wog, Wwf^Es, Wwg, Wog^Bw\r, Rp, Rp, Gd, Rp, Rp, Gd, Rd^Uf, Wwf, Rd, Gd^Fdw, Gd^Edb, Gd, Rp, Gd, Hhd^Fdw, Hhd, Md
Hhd, Gd, Gd^Edb, Rd, Hhd^Fdw, Rp, Rd, Chr^Dr, Wwf^Es, Sm, Rd^Fdw, Mm^Xm, Gd, Gd, Hhd^Fdw, Rp^Vd, Wwf^Es, Wwg, Wwrg, Gd^Edb, Gd^Edb, Gd^Fetd, Ai, Rd^Uf, Wwf^Es, Wwf^Es, Rp, Rp, Gd^Edb, Gd, Gd, Gd, Gd^Fdw, Rp^Vd, Chr^Edt, Wwf, Rd, Gd^Edb, Gd, Gd, Rp, Gd, Gd^Fdw, Md, Md
Hhd^Fdw, Hhd^Fdw, Gd^Fdw, Gd, Rp, Rp, Rd, Rd, Wwf^Es, Rd, Hhd^Fdw, Md, Rd, Rd, Wwf, Wwf, Mm^Xm, Mm^Xm, Wwg, Hhd^Uf, Wwf^Es, Wwf, Wwf, Wwf, Mm^Xm, Wog, Rp, Gd^Edb, Chr^Dr, Gd^Fdw, Rd^Uf, Gd, Gd, Rb, Rb^Dr, Wwf^Bw\r, Rp, Gd^Fetd, Khr, Rb^Dr, Rp, Gd, Gd, Gd^Fdw, Hhd
Aa^Fdw, Gd, Rb, Gd, Rp, Rb^Dr, Rd, Gd^Fdw, Wwf^Es, Wwrg, Wwg, Rd, Wwf, Wwf^Es, Wwf, Sm^Uf, Wwrg, Ai, Ai, Wwf, Rd, Rd, Wwf, Md, Hhd^Uf, Sm, Rp, Gd^Edb, Ai, Md, Gd^Fdw, Gd, Rb, Gd, Rb, Wwf^Es, Sm, Rp, Chr, Rp, Gd, Gd, Hhd^Fdw, Gd, Ha
Ha, Aa^Fdw, Aa, Gd, Gd^Fdw, Rp, Rp, Rd^Vd, Wwf, Mm^Xm, Wwf^Fdw, Wwf^Es, Wwf, Sm^Dr, Rd, Wwf, Rd, Chr, Rd, Rd, Gd, Rd, Rb^Dr, Wwf, Wwf, Sm^Vhs, Rd, Rp, Rp, Gd, Gd^Edb, Gd^Edb, Gd, Gd, Sm^Fdw, Sm^Es, Gd, Sm, Chr, Rb, Gd^Fdw, Hhd, Hhd, Gd^Fetd, Ha
Ms^Xm, Ha, Ha^Fdw, Gd, Md, Hhd, Rp, Rd^Edb, Wwf^Es, Wwf^Es, Wwf, Wwf, Rd, Rd, Md, Ai, Gd, Gd, Gd^Edt, Gd^Edt, Gd, Sm^Fdw, Gd, Rd, Rd, Rd^Edb, Rb^Dr, Gd, Gd, Rp, Rp, Gd, Gd, Rb^Dr, Gd^Fdw, Gd, Rd, Rd, Khr, Sm^Bw\r, Sm^Bw\r, Sm^Fdw, Sm, Hhd^Fdw, Md
Ms^Xm, Ms^Xm, Ms, Hhd^Fdw, Sm, Hhd^Uf, Wwf^Es, Wog^Bw\r, Wwg^Bw\r, Ai^Dr, Wwf, Wwf, Rd, Gd^Fdw, Gd, Gd, Gd^Edb, Ai, Hhd^Fdw, Md, Gd, Gd, Gd, Gd^Em, Md, Rd^Edb, Chr^Edb, Rd, Gd, Gd, Gd^Fdw, Rp, Rp, Gd, Rd, Rd, Chr^Edt, Chr, Sm^Fdw, Sm, Ai, Sm^Bw\r, Ai, Ha, Ms^Xo
Ms^Xm, Ms^Xm, Ms^Xm, Ai, Wog, Wwg, Wwrg, Wwf, Hhd^Fdw, Rp, Rp, Wwf, Chr, Hhd^Fdw, Gd, Gd, Rd^Uf, Mm^Xm, Rd, Gd, Gd^Fdw, Hhd, Rb, Hhd^Fdw, Gd^Fdw, Ai, Rd, Rd, Gd^Edb, Hhd^Fdw, Hhd, Gd, Rp, Chr, 1 Khr, Chr^Edt, Ai^Bw\r, Ai, Sm, Ai, Sm^Fdw, Sm^Fdw, Hhd^Xo, Ha^Xo, Ha^Xo
Ms^Xm, Ms^Xm, Ai^Xo, Ai, Ai, Wwg, Khw, Chw, Gd, Gd, Rp, Wwf, Wwf^Bw/r, Rp, Rp, Rp, Rp, Chr^Vhcr, Rd, Gd^Edt, Gd, Gd, Gd, Gd, Gd, Rd, Gd^Es, Gd, Rp, Hhd^Vhcr, Rp, Rp, Rd, Rp, Rd, Rd, Sm, Sm^Bw\r, Ai, Sm, Md^Xo, Hhd^Xo, Hhd^Xo, Hhd^Xo, Ms^Xo
Ai^Xo, Ai^Xo, Ai^Xo, Ai^Xo, Ai^Xo, Ha, Ha, Ai, Gd, Rb^Dr, Gd^Fdw, Rp, Rd, Wwf, Wwf^Es, Rd, Rd, Chr, Chr, Rd^Edb, Rd^Edb, Rd, Chr, Gd, Gd^Es, Gd^Es, Rp, Rp, Gd^Fdw, Rp, Rp, Gd^Fdw, Chr^Edb, Rd, Sm^Fdw, Sm^Fdw, Ai, Sm^Fdw, Sm^Xo, Sm^Xo, Hhd^Xo, Hhd^Xo, Md^Xo, Md^Xo, Ms^Xo
Ai^Xo, Ai^Xo, Ai^Xo, Ai^Xo, Ai^Xo, Ms^Xm, Ms, Aa^Fdw, Aa^Fdw, Hhd^Fdw, Gd^Fetd, Gd, Md, Rd, Rd, Wwf^Es, Sm, Sm^Bw\r, Sm^Bw\r, Khr, Chr, Chr, Sm, Chr, Khr, Rp, Rd, Rb^Dr, Chr^Edb, Gd, Rp, Gd^Fdw, Rd^Em, Rd, Ai, Ai, Sm^Xo, Sm^Xo, Hhd^Xo, Hhd^Xo, Mv^Xo, Md^Xo, Md^Xo, Md^Xo, Ms^Xo
Ai^Xo, Ai^Xo, Ai^Xo, Ai^Xo, Ms^Xm, Ms^Xm, Ms^Xm, Ha, Hhd, Md, Gd, Gd, Rd^Uf, Hhd^Fdw, Rb, Rd, Ai, Rd, Rd, Sm^Bw\r, Sm^Bw\r, Sm, Hhd, Rd, Rd^Fdw, Rd, Gd, Chr^Edb, Gd^Fdw, Gd, Gd^Em, Rp, Rp, Chr^Dr, Ai^Xo, Sm^Xo, Hhd^Xo, Hhd^Xo, Md^Xo, Md^Xo, Md^Xo, Md^Xo, Md^Xo, Ms^Xo, Ms^Xo
Ai^Xo, Ai^Xo, Ms^Xm, Ms^Xm, Ms^Xm, Ms^Xm, Ms^Xm, Ms, Md, Gd^Fdw, Gd^Fdw, Gd, Gd, Gd, Aa, Aa, Gd^Fdw, Gd^Fdw, Aa, Rd, Ai, Ai^Bw\r, Hhd, Hhd^Fetd, Ha, Hhd, Ha, Gd, Hhd^Fdw, Rd^Uf, Khr, Chr^Dr, Rp, Aa, Ha^Xo, Ha^Xo, Md^Xo, Md^Xo, Md^Xo, Md^Xo, Md^Xo, Md^Xo, Md^Xo, Ms^Xo, Ms^Xo
Ms^Xm, Ms^Xm, Ms^Xm, Ms^Xm, Ms^Xm, Ms^Xm, Ms^Xm, Ms^Xm, Ms^Xm, Md, Md, Hhd^Fdw, Hhd, Aa, Ms^Xm, Ha, Ms^Xm, Hhd, Ms^Xm, Aa, Ai, Ha, Ms^Xm, Ha, Ms^Xm, Md, Ms^Xm, Hhd, Hhd, Gd, Gd, Gd, Rp^Xo, Aa^Xo, Ha^Xo, Ms^Xo, Ms^Xo, Ms^Xo, Ms^Xo, Ms^Xo, Ms^Xo, Md^Xo, Md^Xo, Ms^Xo, Ms^Xo
