Md^Xm       , Md^Xm       , Md^Xm       , Md^Xm       , Md^Xm       , Md^Xm       , Md^Xm       , Md^Xm       , Md^Xm       , Wo          , Md^Xm       , Ms^Xm       , Ms^Xm       , Ms^Xm       , Ms^Xm       , Ms^Xm       , Ms^Xm       , Ms^Xm       , Ms^Xm       , Ms^Xm       , Ms^Xm       , Ms^Xm       , Ms^Xm       
Md^Xm       , Md^Xm       , Md          , Hhd^Fmw     , Gs^Ft       , Hd          , Dd^Esd      , Ds          , Ww          , Ww          , Co          , 2 Ko        , Co          , Rb^Es       , Rb^Es       , Rb          , Aa          , Ha          , Aa^Fma      , Ha^Fpa      , Ms          , Ms^Xm       , Ms^Xm       
Md^Xm       , Hhd^Fdw     , Gs^Ft       , Md          , Dd^Dc       , Dd^Edpp     , Hd          , Ds          , Gd          , Ww          , Wo^Bw/      , Co          , Wo^Bw\      , Gll         , Gll^Fp      , Aa^Es       , Ha^Fma      , Aa          , Ai          , Ms          , Aa^Fda      , Ha^Fpa      , Ms^Xm       
Md^Xm       , Hd          , Dd^Edpp     , Dd^Esd      , Dd^Esd      , Gd^Es       , Gs^Ft       , Gd          , Rp          , Wo^Bw/      , Ww          , Ww          , Gs^Fdw      , Rp          , Rp          , Gd          , Aa          , Ai          , Sm          , Aa          , Aa^Es       , Ha          , Ms^Xm       
Md^Xm       , Dd^Dc       , Gd^Es       , Dd^Esd      , Rd^Tf       , Rd          , Rp          , Dd^Vht      , Dd^Esd      , Gd          , Gd^Es       , Ww          , Wwr         , Gd          , Aa^Fma      , Aa^Voa      , Rp          , Rb^Tf       , Aa          , Ai          , Ha          , Aa          , Ms^Xm       
Md^Xm       , Dd^Esd      , Rd          , Rd          , Dd^Esd      , Rp          , Gd          , Hd          , Wwf         , Gd^Fmw      , Gll         , Wwf         , Ww          , Gd          , Gd          , Aa^Fpa      , Gll^Es      , Rp          , Aa^Es       , Aa^Fma      , Rb          , Aa^Es       , Ms^Xm       
Mm^Xm       , Rd          , Rd          , Hhd^Fdw     , Hd          , Rp          , Gd^Fdf      , Gs          , Wwf         , Wwf         , Gll         , Gll         , Ww          , Hhd         , Gll^Es      , Gd          , Gll         , Rp          , Sm          , Sm          , Rb          , Rb^Es       , Mm^Xm       
Mm^Xm       , Co          , Co          , Co          , Co          , Ko          , Ww^Ewl      , Gd          , Gd^Es       , Gd          , Gll^Fp      , Hhd^Vd      , Rb^Tf       , Ww          , Gd          , Gd          , Gs          , Ko          , Co          , Co          , Co          , Co          , Mm^Xm       
Mm^Xm       , Gd^Fmw      , Gd          , Gll^Es      , Gd          , Rp          , Ww^Ewl      , Ww^Ewl      , Rb^Tf       , Gd          , Gs          , Gd          , Gs^Fds      , Wwf         , Ww          , Hhd^Fdf     , Gs          , Rp          , Sm          , Gll         , Gll         , Gll         , Mm^Xm       
Mm^Xm       , Gll         , Gd          , Gd          , Wwf         , Rp          , Rp          , Ww^Ewl      , Hhd^Fmw     , Gs          , Gs          , Ww^Ewl      , Gs          , Ds          , Wwr         , Ww          , Wo^Bw/      , Rp          , Gs          , Gs          , Gd          , Hhd         , Mm^Xm       
Mm^Xm       , Mm          , Hh          , Gll         , Gs          , Hhd         , Gs          , Rp          , Gs^Fdw      , Gg          , Gg          , Gs          , Mm          , Ds          , Gd          , Wo^Bw/      , Ww          , Ww          , Ds          , Gll^Fmf     , Gs          , Gd^Es       , Mm^Xm       
Mm^Xm       , Hh^Fp       , Gs          , Gg          , Gd          , Gs          , Gs^Fms      , Gd^Vo       , Gd          , Gg^Efm      , Gg          , Hh^Fms      , Hh          , Gd^Es       , Gd          , Gd^Vc       , Gs^Fds      , Wwf         , Ww          , Ds          , Gd          , Gd          , Mm^Xm       
Mm^Xm       , Gs          , Gd          , Gs^Es       , Gd          , Ds          , Ds          , Rp          , Hhd         , Gd          , Gs          , Ds          , Ds          , Gs          , Rb^Tf       , Rp          , Gd          , Ds          , Ww          , Ww          , Gs          , Gs          , Mm^Xm       
Mm^Xm       , Gs          , Gs          , Gll^Fp      , Gd^Fmw      , Hhd         , Rb^Tf       , Rp          , Rp          , Gd          , Ww^Ewl      , Ww^Ewl      , Ds          , Gs^Es       , Rp          , Rp          , Gs          , Ds          , Wwf         , Gs^Es       , Gs          , Gs^Fms      , Mm^Xm       
Md^Xm       , Gll^Es      , Gd          , Ss          , Hhd^Fdw     , Co          , Co          , Co          , Ko          , Gd^Fmw      , Mm          , Hh^Vu       , Gg^Efm      , Gg          , Ko          , Co          , Co          , Co          , Ww          , Wwr         , Gg          , Gs          , Mm^Xm       
Md^Xm       , Hh^Fms      , Gd          , Rd^Tf       , Ss          , Ss          , Wwf         , Gd^Es       , Gd          , Gll^Fp      , Gs          , Hh          , Gs          , Gs          , Gs          , Gd          , Gd^Es       , Wwf         , Gs          , Ww          , Gs          , Gg^Efm      , Mm^Xm       
Md^Xm       , Gll         , Gll         , Ds          , Ds          , Gs^Es       , Gd          , Wwf         , Wwf         , Gs          , Hh^Fp       , Gs          , Gs          , Gs          , Gs^Fdw      , Gd          , Ww          , Ww          , Gs^Es       , Hh^Fds      , Gd^Es       , Gs          , Mm^Xm       
Md^Xm       , Hh          , Gs^Fms      , Gs          , Gg          , Gs          , Gs          , Ss          , Ww          , Gd^Fmw      , Wwf         , Ds          , Gg^Efm      , Gs^Es       , Wwf         , Wwf         , Gg^Efm      , Wwr         , Gg          , Gd          , Gd          , Hh^Tf       , Mm^Xm       
Md^Xm       , Mm          , Gs^Es       , Gs          , Gd^Es       , Hh          , Gs          , Gs          , Wwf         , Wwf         , Gs^Es       , Wwf         , Wwf         , Wwf         , Ww          , Gs          , Gg          , Hh          , Gg          , Gg          , Gs^Fms      , Mm          , Mm^Xm       
Mm^Xm       , Hh^Tf       , Gg          , Gs          , Gg          , Wwr         , Ww          , Wwf         , Gs^Fet      , Gg^Efm      , Gg          , Ds          , Hh^Fds      , Gs^Fds      , Wwf         , Ss          , Gs^Es       , Gs          , Ds          , Gs          , Gs          , Hh          , Md^Xm       
Mm^Xm       , Gs          , Gs          , Hh^Fp       , Gg^Efm      , Ww          , Gs^Es       , Gs          , Gs          , Gd          , Gs          , Gg          , Gs^Es       , Gg          , Gs          , Wwf         , Wwf         , Gg          , Ss          , Ds          , Gg          , Gs          , Md^Xm       
Mm^Xm       , Gs          , Gd          , Ww          , Ww          , Wwf         , Cd          , Gg          , Kd          , Gs          , Gs          , Hh          , Mm          , Gs^Fms      , Kd          , Gs          , Cd          , Ss          , Hh^Fp       , Rd^Tf       , Gs          , Hh^Fms      , Md^Xm       
Mm^Xm       , Gd^Es       , Gd          , Wwr         , Wwf         , Cd          , Gs^Es       , Cd          , Rp          , Gs          , Ds          , Hh^Vud      , Ww^Ewf      , Gs^Fds      , Rp          , Cd          , Rb^Tf       , Cd          , Gs^Fms      , Ss          , Gs          , Gd^Es       , Md^Xm       
Mm^Xm       , Gd^Fmw      , Gs          , Gs          , Ww          , Ds          , Gs          , Rp          , Rb^Tf       , Gg^Efm      , Ds          , Ww^Ewl      , Gs^Es       , Gg          , Hh          , Rp          , Ds          , Hh          , Gd          , Gs^Fds      , Gs^Es       , Gs          , Md^Xm       
Mm^Xm       , Gs          , Gg^Efm      , Ww          , Ww          , Ds          , Gs^Fds      , Rp          , Gd^Es       , Gg          , Hh          , Ds          , Gs          , Gs          , Gg^Efm      , Rp          , Gs^Fds      , Ds          , Gs          , Gs          , Gd          , Gs          , Md^Xm       
Mm^Xm       , Gs          , Gs          , Ds          , Ds          , Wwf         , Ww          , Dd^Vda      , Gd          , Gs          , Mm          , Hh^Fds      , Gd          , Gg          , Gs^Fms      , Gg^Ve       , Gs          , Gs          , Gs^Es       , Gd          , Hh          , Hh^Fms      , Md^Xm       
Mm^Xm       , Gs          , Gs          , Gs^Fdw      , Gd^Es       , Ww          , Wo^Bsb/     , Wo^Bsb/     , Wwr         , Ds          , Gs^Fms      , Gs          , Gs^Es       , Gs          , Hh^Fds      , Rp          , Rp          , Hh          , Wwf         , Gs          , Gs          , Mm          , Md^Xm       
Mm^Xm       , Hh          , Gs          , Gs^Es       , Sm          , Rp          , Gd          , Ww          , Ww          , Ds          , Gg          , Ww^Ewl      , Gs          , Gd^Es       , Rb^Tf       , Ww^Ewl      , Ww^Ewl      , Rp          , Gd^Es       , Gs          , Gd^Es       , Gs          , Md^Xm       
Mm^Xm       , Gs          , Cd          , Gs          , Cd          , Rp          , Gs          , Hhd^Fmw     , Gd          , Wwf         , Rb^Tf       , Gs          , Gll^Fp      , Gs^Es       , Gs          , Ww^Ewf      , Ww^Ewf      , Rp          , Cd          , Gd          , Cd          , Gs^Fdw      , Md^Xm       
Mm^Xm       , Cd          , Rb^Es       , Cd          , Sm          , Kd          , Gll^Es      , Gs          , Gs          , Ww          , Ww          , Hh^Vl       , Gs          , Gg          , Wwf         , Gg^Efm      , Gs^Fdw      , Kd          , Hd          , Cd          , Rd          , Cd          , Mm^Xm       
Ms^Xm       , Rb          , Rb          , Sm          , Aa^Es       , Rp          , Gll         , Gd          , Gll         , Hhd         , Ww          , Gs          , Gd          , Wwf         , Wwf         , Gs          , Gs          , Rp          , Dd^Esd      , Hhd^Fdw     , Rd          , Rd          , Md^Xm       
Ms^Xm       , Aa          , Ha          , Aa^Fpa      , Ai          , Rp          , Rp          , Aa^Fma      , Aa^Fda      , Gll         , Wwr         , Wwf         , Gd          , Gs^Fds      , Dd^Edpp     , Hd          , Rp          , Rp          , Rd^Tf       , Gd          , Gd^Es       , Dd^Dc       , Md^Xm       
Ms^Xm       , Aa          , Aa^Es       , Ai          , Sm          , Rb^Tf       , Aa          , Aa^Vhca     , Rp          , Gd          , Gs^Fet      , Ww          , Ww          , Gd^Es       , Rp          , Dd^Vda      , Gs^Ft       , Rd          , Dd^Esd      , Dd^Esd      , Dd          , Dd          , Md^Xm       
Ms^Xm       , Ha          , Aa^Fma      , Ai          , Aa          , Aa^Es       , Ha^Fpa      , Gd^Es       , Gll^Fp      , Rp          , Wo^Bsb\     , Ww          , Wo^Bsb/     , Wo^Bsb/     , Rd          , Rd          , Hd          , Rd          , Dd^Dc       , Dd          , Gs^Ft       , Hd          , Md^Xm       
Ms^Xm       , Ha^Fpa      , Ms          , Ms          , Aa^Fma      , Aa^Es       , Aa          , Aa          , Rb^Es       , Gd          , Cd          , Cd          , Cd          , Ww          , Ww          , Ds          , Dd^Esd      , Dd^Edpp     , Gs^Ft       , Md          , Md          , Hhd^Fmw     , Md^Xm       
Ms^Xm       , Ms^Xm       , Ms^Xm       , Ha^Fma      , Ms^Xm       , Ha          , Ms^Xm       , Rb          , Ms^Xm       , Rb          , Ms^Xm       , 1 Kd        , Md^Xm       , Ww          , Md^Xm       , Ds          , Md^Xm       , Hd          , Md^Xm       , Hhd^Fdw     , Md^Xm       , Md^Xm       , Md^Xm       
Ms^Xm       , Ms^Xm       , Ms^Xm       , Ms^Xm       , Ms^Xm       , Ms^Xm       , Ms^Xm       , Ms^Xm       , Ms^Xm       , Ms^Xm       , Ms^Xm       , Md^Xm       , Md^Xm       , Wo          , Md^Xm       , Md^Xm       , Md^Xm       , Md^Xm       , Md^Xm       , Md^Xm       , Md^Xm       , Md^Xm       , Md^Xm       
