border_size=1
usage=map

Gd^Fdw      , Hhd^Fmw     , Hhd^Fdw     , Gd          , Gd          , Ds          , Sm          , Sm          , Re          , Re          , Re          , Ce          , Ce          , Ce          , Wwf         , Wwf         , Ce          , Wwf         , Gd^Fmw      , Gd^Fdw      , Gd^Fmw      , Gd          , Gd          , Gd          , Gll         , Hhd         , Hhd         , Md          , Sm          , Sm          
Hhd^Fmf     , Gd^Fdf      , Gd^Es       , Gd^Es       , Gd^Edp      , Gll         , Gll^Fmf     , Sm          , Hhd         , Re          , Re          , Ce          , Ce          , Ce          , 2 Ke        , Ce          , Ce          , Wwf         , Gll^Es      , Gd          , Gd^Es       , Gd          , Sm          , Gll         , Gll^Fmw     , Gd          , Gd^Es       , Gll^Fmf     , Sm          , Gll^Fp      
Gll^Fp      , Gd          , Gd          , Gll^Es      , Gll         , Gd          , Gd          , Hhd^Fmf     , Gll         , Gll^Vhs     , Wwf         , Wwf         , Ce          , Wwf         , Wwf         , Wwf         , Wwf         , Wwf         , Wwf         , Gll^Vda     , Rd^Uf       , Gd^Edp      , Re          , Rb          , Co          , Gd          , Gd          , Gll^Vu      , Hhd^Fp      , Hhd^Fmf     
Gd^Fmw      , Ds          , Sm          , Hhd^Fdw     , Hhd^Vl      , Gd          , Gd          , Gd^Es       , Gll^Edp     , Gll^Es      , Wwf         , Wwg         , Wwg         , Wwg         , Rd          , Gd^Fdf      , Gd          , Ds          , Gd          , Wwg         , Wwg         , Rd          , Ds          , Rb          , Ko          , Gll^Es      , Gd^Es       , Gll         , Gll         , Hhd         
Gd          , Hhd^Fmw     , Hhd         , Md          , Rb          , Gd          , Gd          , Gd^Es       , Gd          , Gll         , Wwf         , Hhd         , Gd          , Gd          , Rd          , Gd^Es       , Gd^Edp      , Gd          , Gll         , Gll^Fp      , Wwg         , Rb^Fmf      , Wwf         , Wwf         , Wwf         , Co          , Gll^Fdw     , Gd^Edp      , Gd          , Rd^Uf       
Gd          , Gd          , Gd          , Rb          , Cud         , Rb          , Kud         , Ds          , Wwf         , Gll^Fdw     , Wwf         , Ds          , Gd          , Gll^Fp      , Hhd^Fmf     , Rd          , Rd          , Gd          , Gll^Es      , Gll^Fmw     , Rd          , Wwf         , Hhd^Fdw     , Md          , Hhd         , Wwf         , Hhd^Fmw     , Gd^Es       , Gd          , Gd          
Wwf         , Gd^Es       , Wwf         , Gd^Edp      , Wwf         , Cud         , Wwf         , Wwf         , Rd^Uf       , Wwf         , Re          , Wwf         , Wwf         , Md          , Gll^Es      , Hhd^Vo      , Rd          , Gll^Fdw     , Gd          , Rd          , Kdr         , Wwf         , Wwf         , Hhd^Uf      , Wwf         , Wwf         , Hhd         , Gd          , Gll^Es      , Gll         
Ds          , Wwf         , Gll^Fp      , Wwf         , Hhd^Fmw     , Wwf         , Gd          , Gd          , Gd^Es       , Gd^Es       , Chr         , Re          , Wwf         , Gll^Es      , Gll^Fmf     , Rd          , Gd          , Gd^Edp      , Gd          , Cdr         , Cdr         , Wwf         , Gll^Fdf     , Wwf         , Gd          , Gd^Vd       , Gd          , Gd          , Gll         , Hhd^Fdw     
Gll^Fmf     , Ds          , Gd^Fmw      , Hhd         , Gd          , Gd          , Gd^Vc       , Gd          , Gd          , Gd          , Khr         , Chr         , Wwf         , Rb^Uf       , Rd^Esd      , Rd          , Hhd^Fdf     , Gd^Es       , Gll^Fp      , Ds          , Wwf         , Wwf         , Gll         , Gll^Fmf     , Gd          , Gd^Es       , Gd          , Gd          , Sm          , Sm          
Gll^Uf      , Sm          , Gd          , Gd          , Gd          , Gd          , Gd^Fmf      , Hhd^Fdw     , Md          , Re^Esd      , Wwf         , Wwf         , Wwg         , Wwf         , Rd^Esd      , Rd^Esd      , Wwf         , Md          , Wwf         , Wwf         , Rd^Esd      , Hhd         , Gll         , Gd^Edp      , Gd          , Gd          , Gd          , Rd^Uf       , Ds          , Sm          
Hhd^Fmw     , Gll^Uf      , Gd          , Gd^Es       , Gd          , Gll^Edp     , Hhd         , Md^Xm       , Wwf         , Wwf         , Wwg         , Wwg         , Wwg         , Wwg         , Wwg^Bw|     , Wwg^Bw|     , Wog         , Wwf         , Wwg         , Wwf         , Rd^Esd      , Rd^Esd      , Sm          , Gll         , Gd          , Gd          , Gd          , Hhd^Fmw     , Md          , Ds          
Gll^Fdw     , Gll^Fmw     , Gll^Edp     , Gd          , Gd          , Gd^Es       , Hhd^Fmf     , Md^Xm       , Wwf         , Wwf         , Wwg         , Wog         , Wog         , Wog         , Wog^Bw|     , Wog^Bw|     , Wog         , Wwg         , Wwg         , Wwg         , Wwf         , Hhd^Fmf     , Md^Xm       , Sm          , Ds          , Gd          , Gd          , Gll^Es      , Hhd         , Hhd^Fdw     
Hhd^Fdw     , Hhd         , Gll         , Gd          , Gd          , Ds          , Sm          , Md^Xm       , Hhd^Fp      , Wwf         , Wwg         , Wwg         , Wwg         , Wog         , Wog^Bw|     , Wog^Bw|     , Wog         , Wog         , Wog         , Wwg         , Wwf         , Wwf         , Md^Xm       , Hhd^Fdw     , Gd          , Gd^Es       , Gd          , Gd          , Gll^Fdw     , Gll^Fmw     
Ds          , Md          , Hhd^Fdw     , Gd          , Gd          , Gd          , Gd^Es       , Sm          , Rd^Esd      , Rd^Esd      , Wwf         , Wwg         , Wwf         , Wog         , Wwg^Bw|     , Wwg^Bw|     , Wwg         , Wwg         , Wwg         , Wwg         , Wwf         , Wwf         , Md^Xm       , Hhd         , Gll         , Gd          , Gd          , Gd          , Gll^Uf      , Hhd^Fmw     
Sm          , Ds          , Re^Uf       , Gd          , Gd^Edp      , Gd          , Gd          , Gd          , Hhd         , Rd^Esd      , Wwf         , Wwf         , Md          , Wwf         , Rd^Esd      , Rd^Esd      , Wwf         , Wwg         , Wwf         , Wwf         , Re^Esd      , Md          , Hhd^Fdf     , Gd^Fmw      , Gd          , Gd^Edp      , Gd          , Gd          , Sm          , Gll^Uf      
Sm          , Sm          , Gd          , Gd^Es       , Gd          , Gd          , Gd^Fmw      , Gd          , Wwf         , Wwf         , Ds          , Gll^Fmf     , Gd          , Hhd^Fdw     , Rd          , Rd^Esd      , Rb^Uf       , Wwf         , Chr         , Khr         , Gd          , Gd^Es       , Gd          , Gd^Vl       , Gd          , Gd^Es       , Hhd         , Gd^Fdw      , Ds          , Gll^Fp      
Hhd^Fdw     , Gd          , Gd          , Gd          , Gll^Vu      , Gll         , Wwf         , Gd^Fdw      , Wwf         , Cdr         , Cdr         , Gd          , Gd^Es       , Gd          , Rd          , Gd^Fdf      , Gll^Es      , Wwf         , Re          , Chr         , Gd          , Gd^Edp      , Gll         , Gll^Es      , Wwf         , Hhd^Fp      , Wwf         , Gll^Fmf     , Wwf         , Ds          
Gll^Edp     , Gd          , Gd          , Hhd         , Wwf         , Wwf         , Hhd^Uf      , Wwf         , Wwf         , Kdr         , Rd          , Gd          , Gd^Fmw      , Rd          , Hhd^Vda     , Gll^Es      , Md          , Wwf         , Wwf         , Re          , Wwf         , Rb^Uf       , Wwf         , Wwf         , Cud         , Wwf         , Gd^Es       , Wwf         , Gd^Es       , Wwf         
Gll         , Gll         , Gd          , Hhd^Fdf     , Wwf         , Hhd         , Md          , Hhd^Fmw     , Wwf         , Rd          , Gll^Fmw     , Gll         , Gd^Edp      , Rd          , Rd          , Hhd^Fdf     , Gll^Fmf     , Gd^Edp      , Ds          , Wwf         , Gd^Fdf      , Wwf         , Ds          , Kud         , Rb          , Cud         , Rb          , Gd          , Gd          , Gll^Es      
Re^Uf       , Gll^Es      , Gll         , Gll^Fmf     , Co          , Wwf         , Wwf         , Wwf         , Rb^Fp       , Wwg         , Gll^Fmf     , Gd          , Gd          , Gd          , Gd          , Rd          , Gd^Es       , Gd          , Hhd         , Wwf         , Gd          , Gd          , Gd          , Gd          , Gd^Edp      , Rb          , Md          , Hhd         , Hhd^Fdf     , Gll         
Hhd         , Gll^Edp     , Gd          , Gd          , Gd^Es       , Ko          , Rb          , Ds          , Rd          , Wwg         , Wwg         , Gd^Es       , Ds          , Gd          , Gd^Fdw      , Rd          , Wwg         , Wwg         , Wwg         , Wwf         , Gll^Es      , Gd          , Gd          , Gd^Edp      , Gd          , Hhd^Vc      , Hhd^Fmf     , Sm          , Ds          , Gll^Fmf     
Hhd^Fdw     , Hhd^Fdw     , Gd^Vo       , Gd          , Gd          , Co          , Rb          , Re          , Gd^Edp      , Rd^Uf       , Gd^Vd       , Wwf         , Wwf         , Wwf         , Wwf         , Wwf         , Wwf         , Ce          , Wwf         , Wwf         , Gll^Vhs     , Gd          , Hhd^Fdw     , Gd^Es       , Gd          , Gd          , Gd^Es       , Gll         , Gll         , Gll^Fp      
Gd^Fmw      , Sm          , Gll^Fp      , Gd          , Gd          , Gd^Fdw      , Gll         , Sm          , Gd^Es       , Gd          , Gll         , Gll         , Wwf         , Ce          , Ce          , 1 Ke        , Ce          , Ce          , Ce          , Re          , Re          , Hhd         , Sm          , Gd^Fmw      , Gd          , Gd          , Gll         , Gll^Edp     , Gll^Fp      , Hhd^Fdw     
Sm          , Sm          , Md          , Hhd         , Hhd         , Gll         , Gd          , Gd          , Gd          , Gll^Fmf     , Gll^Fmw     , Gll^Fmw     , Wwf         , Ce          , Wwf         , Wwf         , Ce          , Ce          , Ce          , Re          , Re          , Re          , Sm          , Sm          , Ds          , Gd^Es       , Gll         , Hhd^Fdf     , Hhd^Fp      , Gll^Fp      
