Wot, Wot, Ww, Ww, Wwf, Rd, Rd, Ww, Ww, Rd, Ww, Rd, Ww, Ww, Rd, Rd, Rd, Rd, Rd, Rd, Rd, Re^Fdw, Re^Fdw, Re^Fdw, Re^Fdw, Re^Fdw, Re^Fdw, Re^Fdw, Re^Fdw, Re^Fdw, Re^Fdw, Re^Fdw, Hhd, Hhd, Md, Md, Re^Fdw, Re^Fdw, Ww, Ww, Rd, Rd, Rd
Ww, Ww, Cfr, Wwf, Wwf, Wwf, Rd, Rd, Rd, Ww, Ww, Ww, Rd, Rd, Re^Fdw, Re^Fdw, Rd, Rd, Rd, Rd, Re^Fdw, Rd, Rd, Re^Fdw, Rd, Rd, Rd, Rd, Rd, Rd, Rd, Re^Fdw, Md^Xm, Md, Re^Fdw, Hhd, Rd, Rd, Ww, Ww, Ww, Ww, Ww
Rd, Cfr, 2 Kfr, Cfr, Ww, Wo, Ww, Rd, Rd, Rd, Ww, Rd, Hhd, Rd, Rd, Rd, Rd, Rd, Rd^Vct, Rd, Re^Fdw, Rd, Rd, Rd, Rd, Rd, Rd, Rd, Rd, Rd, Rd, Rd, Rd, Md, Md, Md, Ww, Ww, Rd, Rd^Vct, Rd, Rd, Ww
Rd, Cfr, Cfr, Cfr, Rd, Ww, Ww, Ww^Vm, Ww, Ww, Re^Fdw, Rd, Rd, Rd, Re^Fdw, Rd, Rd, Rd, Rd, Rd, Rd, Rd, Rd^Vct, Rd, Md, Re^Fdw, Re^Fdw, Re^Fdw, Md^Xm, Re^Fdw, Md, Rd, Rd, Rd, Rd, Ww, Rd, Rd, Rd, Rd, Ww, Ww, Rd
Rd, Rd, Rd, Rd, Rd, Rd, Ww, Wo, Ww, Re^Fdw, Rd, Rd, Rd, Re^Fdw, Rd, Rd, Rd, Re^Fdw, Re^Fdw, Rd, Rd, Rd, Rd, Rd, Rd, Md, Md, Md, Re^Fdw, Md, Hhd, Hhd, Rd, Rd, Ww, Ww, Rd, Rd, Ww, Ww, Rd, Ww, Rd
Rd, Rd, Rd, Rd, Rd, Rd, Rd^Vct, Wo, Ww, Rd, Rd, Rd, Re^Fdw, Rd, Hhd, Rd, Rd, Rd, Rd, Rd, Hhd, Rd, Md, Rd, Rd, Rd, Hhd, Re^Fdw, Rd, Hhd, Ww, Ww, Ww, Ww, Rd, Rd, Rd, Re^Fdw, Ww, Re^Fdw, Ww, Ww, Ww
Rd, Rd, Rd, Rd, Rd, Rd, Rd, Ww, Wo, Hhd, Hhd, Rd, Rd, Re^Fdw, Rd, Hhd, Rd, Rd^Vct, Rd, Rd, Hhd, Re^Fdw, Md, Re^Fdw, Rd, Rd, Rd, Rd, Rd, Ww, Rd, Rd, Rd, Rd, Rd^Vct, Rd, Rd, Re^Fdw, Ww, Ww, Rd, Rd, Ww
Rd, Rd, Rd, Rd, Hhd, Hhd, Rd, Ww, Wo, Rd, Rd, Rd, Rd, Rd, Re^Fdw, Rd, Rd, Rd, Rd, Hhd, Md^Xm, Md, Hhd, Re^Fdw, Rd, Rd, Rd, Rd, Ww, Ww, Rd, Re^Fdw, Rd, Rd, Rd, Rd, Ww, Ww, Ww, Rd, Ww, Rd, Ww
Rd, Rd^Vct, Re^Fdw, Rd, Rd, Rd, Re^Fdw, Ww^Vm, Ww, Ww, Re^Fdw, Re^Fdw, Rd, Rd, Rd, Rd, Re^Fdw, Rd, Rd, Hhd, Re^Fdw, Re^Fdw, Rd, Rd, Rd, Rd, Ww, Ww, Rd, Re^Fdw, Re^Fdw, Rd, Re^Fdw, Rd, Rd, Ww, Re^Fdw, Rd, Rd, Ww, Rd, Ww, Rb
Rd, Rd, Hhd, Re^Fdw, Rd, Re^Fdw, Hhd, Rd, Ww, Wo, Ww, Rd, Rd^Vct, Rd, Re^Fdw, Re^Fdw, Md^Xm, Rd, Rd, Rd, Rd, Rd, Ce, Rd, Rd, Rd^Vct, Ww, Rd, Rd, Rd, Re^Fdw, Rd, Re^Fdw, Re^Fdw, Rd, Ww, Re^Fdw, Rd, Rd, Rd, Re^Fdw, Re^Fdw, Md
Re^Fdw, Hhd, Rd, Re^Fdw, Rd, Rd, Rd, Re^Fdw, Re^Fdw, Ww, Wo, Ww, Ww, Hhd, Md, Md, Md, Md, Rd, Rd, Rd, Ket, Ket, Rd, Ww, Ww, Rd, Rd, Rd, Rd, Ww, Re^Fdw, Rd, Rd, Ww, Ww, Rd, Rd, Md, Md, Md^Xm, Md^Xm, Rd
Re^Fdw, Rd, Rd, Rd^Vct, Rd, Rd, Rd, Rd, Rd, Rd, Re^Fdw, Wo, Wo, Re^Fdw, Re^Fdw, Re^Fdw, Rd, Rd, Rd, Rd, Rd, Ce, Rd, Ww, Re^Fdw, Rd, Rd, Rd, Ww, Ww, Rd, Ww, Ww, Ww, Rd, Rd, Re^Fdw, Rd, Rd, Hhd, Re^Fdw, Rd, Rd
Re^Fdw, Rd, Rd, Rd, Re^Fdw, Re^Fdw, Rd, Rd, Md, Hhd, Rd, Ww, Ww, Ww, Ww^Vm, Rd, Rd, Rd, Rd^Vct, Rd, Ww, Ww, Ww, Ww, Re^Fdw, Re^Fdw, Ww, Ww, Rd, Rd^Vct, Ww, Ww, Rd, Rd, Md, Re^Fdw, Hhd, Rd, Rd, Rd, Re^Fdw, Re^Fdw, Rd
Re^Fdw, Re^Fdw, Rd, Rd, Rd, Rd, Rd, Md, Re^Fdw, Md^Xm, Re^Fdw, Hhd, Rd, Wo, Wo, Rd, Rd, Rd, Rd, Ww, Rd, Rd, Rd, Rd^Vct, Rd, Rd, Ww, Rd, Ww, Ww, Re^Fdw, Rd, Rd, Md, Md^Xm, Md^Xm, Md, Rd, Rd, Rd, Rd, Rd, Ww
Re^Fdw, Re^Fdw, Rd, Rd, Hhd, Rd, Rd, Hhd, Re^Fdw, Hhd, Rd, Rd, Rd, Ww, Ww, Wo, Ww, Ww, Ww, Ww, Ww, Ww, Ww, Rd, Rd, Rd, Ww, Ww, Rd, Rd, Rd, Rd, Md^Xm, Hhd, Re^Fdw, Re^Fdw, Rd, Rd, Rd, Rd, Rd, Ww, Rd
Rd, Rd, Md, Md, Md, Rd, Rd, Rd, Rd, Rd, Rd, Rd, Rd, Rd^Vct, Rd, Wo, Ww, Rd, Rd, Rd, Re^Fdw, Rd, Ww, Rd, Ww, Ww, Rd, Rd, Re^Fdw, Md, Rd, Rd, Md, Rd, Rd, Rd, Rd, Rd, Rd, Rd, Rd^Vct, Ww, Ww
Re^Fdw, Hhd, Md^Xm, Md, Hhd, Hhd, Re^Fdw, Rd, Ket, Ce, Ce, Rd, Rd, Rd, Ww, Ww, Wo, Rd, Rd, Rd, Rd, Rd, Ww, Ww, Re^Fdw, Rd, Md, Re^Fdw, Md^Xm, Md^Xm, Rd, Rd, Ce, Rd, Rd, Rd, Re^Fdw, Rd, Rd, Rd, Ww, Ww, Rd
Re^Fdw, Re^Fdw, Re^Fdw, Hhd, Md^Xm, Re^Fdw, Md^Xm, Rd, Ce, Ket, Rd, Rd, Ww, Ww, Rd, Ww^Vm, Ww, Ww, Rd, Rd, Ww, Ww, Rd, Re^Fdw, Rd, Rd, Md, Hhd, Rd, Rd, Rd, Ket, Ket, Rd, Rd^Vct, Rd, Ww, Rd, Ww, Ww, Ww, Rd, Ww
Re^Fdw, Re^Fdw, Re^Fdw, Md^Xm, Rd, Rd, Rd, Rd, Rd, Rd, Rd, Rd^Vct, Ww, Re^Fdw, Re^Fdw, Rd, Ww, Ww, Rd, Rd^Vct, Ww, Re^Fdw, Rd, Re^Fdw, Hhd, Rd, Rd, Rd, Rd, Rd, Rd, Ce, Rd, Rd, Ww, Ww, Re^Fdw, Ww, Rd, Rd, Ww, Ww, Rd
Re^Fdw, Re^Fdw, Rd, Rd, Rd, Re^Fdw, Rd, Rd, Ww, Ww, Ww, Ww, Rd, Re^Fdw, Rd, Rd, Ww, Wo, Wo, Ww, Rd, Md, Md^Xm, Md^Xm, Md, Rd, Rd, Rd, Re^Fdw, Rd, Ww, Ww, Ww, Ww, Re^Fdw, Ww, Ww, Ww, Ww, Re^Fdw, Ww, Re^Fdw, Rd
Re^Fdw, Rd, Rd^Vct, Rd, Rd, Re^Fdw, Ww, Ww, Rd, Rd, Re^Fdw, Rd, Rd, Rd, Rd^Vct, Rd, Rd, Ww, Ww, Wo, Wo, Hhd, Re^Fdw, Re^Fdw, Rd, Rd, Rd, Rd, Rd, Rd, Ww, Hhd, Hhd, Hhd, Rd, Rd, Rd, Re^Fdw, Hhd, Ww, Rd, Ww, Ww
Ww, Rd, Rd, Rd, Ww, Rd, Ww, Rd^Vct, Rd, Re^Fdw, Rd, Re^Fdw, Re^Fdw, Rd, Rd, Rd, Re^Fdw, Rd, Ww, Wo, Wo, Ww, Ww, Rd, Rd, Rd, Rd, Rd, Rd, Ww, Rd, Re^Fdw, Rd, Rd, Rd^Vct, Rd, Rd, Hhd, Rd, Rd, Rd^Vct, Rd, Rd
Rd, Ww, Ww, Ww, Rd, Ww, Rd, Rd, Ket, Rd, Rd, Rd, Rd, Rd, Rd, Md, Md^Xm, Md^Xm, Ww, Re^Fdw, Re^Fdw, Wo, Wo, Ww^Vm, Rd, Re^Fdw, Re^Fdw, Rd, Ww, Ww, Re^Fdw, Re^Fdw, Rd, Rd, Rd, Rd, Re^Fdw, Rd, Rd, Rd, Rd, Rd, Rd
Ww, Ww, Ww, Rd, Re^Fdw, Rd, Rd, Ce, Ce, Ket, Rd, Rd, Hhd, Rd, Rd, Rd, Rd, Re^Fdw, Rd, Ww, Rd, Re^Fdw, Ww, Wo, Wo, Rd, Rd, Rd, Ww, Re^Fdw, Rd, Rd, Rd, Rd, Rd, Re^Fdw, Rd, Rd, Hhd, Re^Fdw, Re^Fdw, Rd, Rd
Rd, Rd, Ww, Rd, Rd, Rd, Rd^Vct, Rd, Rd, Rd, Rd, Re^Fdw, Hhd, Md^Xm, Re^Fdw, Rd, Rd, Rd, Ww, Ww, Rd, Rd, Rd^Vct, Ww, Ww, Wo, Wo, Ww, Rd, Rd, Rd, Rd, Ket, Ce, Rd, Re^Fdw, Rd, Rd, Re^Fdw, Re^Fdw, Rd, Rd, Md^Xm
Ww, Ww, Rd, Re^Fdw, Re^Fdw, Rd, Rd, Rd, Rd, Rd, Rd, Md^Xm, Md, Re^Fdw, Md, Md, Rd, Rd, Ww, Re^Fdw, Rd, Rd, Rd, Ww, Rd, Wo, Wo, Ww, Ww, Rd^Vct, Rd, Ce, Ce, Ket, Rd, Rd, Rd, Rd, Rd, Rd, Re^Fdw, Re^Fdw, Hhd
Re^Fdw, Re^Fdw, Rd, Re^Fdw, Re^Fdw, Re^Fdw, Rd, Md, Md^Xm, Rd, Rd, Rd, Rd, Rd, Rd, Rd, Rd, Rd^Vct, Rd, Ww, Re^Fdw, Re^Fdw, Rd, Ww, Rd, Rd, Re^Fdw, Wo, Wo, Ww, Rd, Rd, Rd, Rd, Rd^Vct, Rd, Rd, Md^Xm, Hhd, Hhd, Md, Md^Xm, Hhd
Re^Fdw, Rd, Rd^Vct, Rd, Rd, Rd, Rd, Md^Xm, Re^Fdw, Md, Rd, Re^Fdw, Ww, Ww, Ww, Ww, Ww, Rd, Ww, Ww, Ww, Re^Fdw, Ww, Ww, Rd, Rd, Re^Fdw, Rd, Ww, Ww, Rd, Rd, Rd, Rd, Rd, Rd, Rd, Rd, Rd, Md, Re^Fdw, Re^Fdw, Hhd
Rd, Rd, Md, Rd, Md^Xm, Rd, Rd, Rd, Rd, Rd, Re^Fdw, Ww, Rd, Rd^Vct, Rd, Rd, Rd, Ww, Rd, Rd, Ww, Ww, Re^Fdw, Re^Fdw, Rd, Re^Fdw, Rd, Rd, Ww, Ww, Rd, Re^Fdw, Re^Fdw, Rd, Re^Fdw, Hhd, Hhd, Rd, Rd, Hhd, Rd, Rd, Hhd
Ww, Rd, Md^Xm, Hhd, Md, Rd, Re^Fdw, Re^Fdw, Ww, Re^Fdw, Ww, Ww, Ce, Rd, Rd, Re^Fdw, Re^Fdw, Rd, Re^Fdw, Ww, Rd, Rd, Rd, Rd, Rd, Re^Fdw, Rd, Rd, Ww^Vm, Wo, Ww, Rd, Re^Fdw, Hhd, Md, Md, Re^Fdw, Rd, Rd, Rd, Hhd, Hhd, Rd
Hhd, Ww, Ww, Md^Xm, Ww, Rd, Ww, Ww, Re^Fdw, Ww, Rd, Ket, Ket, Rd, Rd, Re^Fdw, Rd, Re^Fdw, Rd, Ww, Rd, Rd, Rd, Rd^Vct, Rd, Rd, Rd, Rd, Rd, Wo, Wo, Ww, Hhd, Md^Xm, Re^Fdw, Md, Md, Md, Rd, Rd, Rd, Rd, Rd
Md, Rd, Ww, Ww, Rd, Ww, Rd, Re^Fdw, Rd, Rd, Rd, Ce, Rd, Rd, Re^Fdw, Rd, Rd, Rd, Rd, Ww, Rd, Re^Fdw, Re^Fdw, Rd, Rd, Rd, Md, Rd, Gll^Fmf, Gll^Fmf, Ww, Wo, Wo, Hhd, Rd, Hhd, Hhd, Md, Rd, Rd, Rd, Hhd, Rd
Ww, Ww, Re^Fdw, Re^Fdw, Ww, Ww, Re^Fdw, Rd, Rd, Rd^Vct, Rd, Rd, Rd, Rd, Rd, Rd, Re^Fdw, Rd, Ww, Ww, Rd, Re^Fdw, Rd, Re^Fdw, Rd, Rd, Md, Hhd, Md, Rd, Hhd, Ww, Ww, Wo, Ww, Hhd, Hhd, Rd, Rd, Rd^Vct, Rd, Hhd, Rd
Rd, Ww, Ww, Ww, Rd, Re^Fdw, Rd, Rd, Rd, Rd, Rd, Rd, Re^Fdw, Rd, Rd, Re^Fdw, Ww, Ww, Re^Fdw, Rd, Rd, Rd, Md, Rd, Rd, Rd, Hhd, Md, Re^Fdw, Hhd, Rd, Rd, Re^Fdw, Ww, Ww, Rd, Rd, Rd, Rd, Rd, Hhd, Hhd, Rd
Ww, Ww, Ww, Re^Fdw, Rd, Rd, Re^Fdw, Rd, Re^Fdw, Rd, Rd, Re^Fdw, Rd, Re^Fdw, Rd, Rd, Ww, Rd, Re^Fdw, Re^Fdw, Rd, Md, Re^Fdw, Md, Rd, Rd, Rd, Re^Fdw, Rd, Rd, Rd^Vct, Rd, Rd, Ww, Wo, Ww^Vm, Re^Fdw, Rd, Rd, Hhd, Rd, Rd, Rd
Rd, Rd, Rd^Vct, Ww, Ww, Re^Fdw, Re^Fdw, Rd, Rd, Re^Fdw, Rd, Re^Fdw, Rd, Rd^Vct, Rd, Ww, Rd, Rd, Re^Fdw, Rd, Hhd, Hhd, Md, Md^Xm, Re^Fdw, Rd, Rd, Rd, Rd, Rd, Rd, Rd, Hhd, Hhd, Wo, Ww, Rd, Re^Fdw, Hhd, Rd, Rd, Rd^Vct, Rd
Ww, Ww, Ww, Rd, Ww, Ww, Ww, Ww, Ww, Re^Fdw, Rd, Rd, Re^Fdw, Rd, Ww, Ww, Rd, Rd, Rd, Rd, Rd, Md, Re^Fdw, Hhd, Rd, Rd, Hhd, Hhd, Rd, Rd, Rd, Rd, Rd, Hhd, Wo, Ww, Rd, Hhd, Rd, Hhd, Rd, Rd, Rd
Ww, Rd, Ww, Ww, Rd, Rd, Re^Fdw, Rd, Rd, Ww, Ww, Ww, Ww, Ww, Rd, Rd, Hhd, Hhd, Md, Rd, Rd, Hhd, Rd, Rd, Re^Fdw, Rd^Vct, Rd, Re^Fdw, Rd, Rd, Rd, Re^Fdw, Rd, Rd, Ww, Wo, Rd^Vct, Rd, Rd, Rd, Rd, Rd, Rd
Ww, Ww, Ww, Re^Fdw, Re^Fdw, Rd, Rd, Re^Fdw, Rd, Rd, Ww, Re^Fdw, Rd, Rd, Hhd, Re^Fdw, Md, Md^Xm, Hhd, Rd, Rd^Vct, Rd, Rd, Rd, Rd, Rd, Rd, Rd, Rd, Rd, Rd, Re^Fdw, Rd, Rd, Ww, Wo, Rd, Rd, Rd, Rd, Rd, Rd, Rd
Ww, Rd, Rd, Ww, Ww, Rd, Ww, Rd, Ww, Ww, Re^Fdw, Re^Fdw, Rd, Rd, Md, Md^Xm, Hhd, Re^Fdw, Re^Fdw, Rd, Rd, Rd, Re^Fdw, Re^Fdw, Rd, Rd, Rd, Re^Fdw, Re^Fdw, Re^Fdw, Rd, Rd, Rd, Rd, Ww^Vm, Wo, Ww, Rd, Rd, Rd, Cfr, Rd, Rd
Rd, Ww, Ww, Ww, Rd^Vct, Ww, Rd, Ww, Re^Fdw, Re^Fdw, Hhd, Hhd, Rd, Rd, Rd, Hhd, Rd, Re^Fdw, Rd, Rd, Re^Fdw, Rd, Rd, Rd, Rd^Vct, Rd, Rd, Rd, Rd, Rd, Ww, Ww, Ww, Ww, Rd, Ww, Ww, Ww, Ww, Cfr, 1 Kfr, Cfr, Rd
Ww, Ww, Ww, Rd, Rd, Ww, Rd, Rd, Re^Fdw, Hhd, Md^Xm, Re^Fdw, Re^Fdw, Re^Fdw, Rd, Rd, Rd, Rd, Rd, Hhd, Hhd, Rd, Rd, Rd, Rd, Rd, Rd, Rd, Ww, Ww, Rd, Rd, Ww, Rd, Rd, Rd, Rd, Wwf, Wwf, Cfr, Cfr, Cfr, Rd
Ww, Re^Fdw, Ww, Rd, Rd, Ww, Hhd, Hhd, Md, Md, Hhd, Hhd, Md, Md, Rd, Re^Fdw, Re^Fdw, Rd, Hhd, Md^Xm, Rd, Rd, Rd, Rd, Rd, Rd, Ww, Ww, Rd, Rd, Ww, Ww, Rd, Ww, Ww, Rd, Rd, Wwf, Wwf, Wwf, Rd, Rd, Rd
