Wot, Wot, Ww, Ww, Wwf, Rb, Rb, Ww, Ww, Rb, Ww, Rb, Ww, Ww, Rb, Rb, Rb, Rb, Rb, Rb, Rb, Gll^Fmf, Gll^Fmf, Gll^Fmf, Gll^Fmf, Gll^Fmf, Gll^Fmf, Gll^Fmf, Gll^Fmf, Gll^Fmf, Gll^Fmf, Gll^Fmf, Hhd, Hhd, Md, Md, Gll^Fmf, Gll^Fmf, Ww, Ww, Rb, Rb, Rb
Ww, Ww, Cfr, Wwf, Wwf, Wwf, Rb, Rb, Rb, Ww, Ww, Ww, Rb, Rb, Gll^Fmf, Gll^Fmf, Rb, Rb, Rb, Rb, Gll^Fmf, Rb, Rb, Gll^Fmf, Rb, Rb, Rb, Rb, Rb, Rb, Rb, Gll^Fmf, Md^Xm, Md, Gll^Fmf, Hhd, Rb, Rb, Ww, Ww, Ww, Ww, Ww
Rb, Cfr, 2 Kfr, Cfr, Ww, Wo, Ww, Rb, Rb, Rb, Ww, Rb, Hhd, Rb, Rb, Rb, Rb, Rb, Gd^Vo, Rb, Gll^Fmf, Rb, Rb, Rb, Rb, Rb, Rb, Rb, Rb, Rb, Rb, Rb, Rb, Md, Md, Md, Ww, Ww, Rb, Re^Vct, Rb, Rb, Ww
Rb, Cfr, Cfr, Cfr, Rb, Ww, Ww, Ww^Vm, Ww, Ww, Gll^Fmf, Rb, Rb, Rb, Gll^Fmf, Rb, Rb, Rb, Rb, Rb, Rb, Rb, Gd^Vo, Rb, Md, Gll^Fmf, Gll^Fmf, Gll^Fmf, Md^Xm, Gll^Fmf, Md, Rb, Rb, Rb, Rb, Ww, Rb, Rb, Rb, Rb, Ww, Ww, Rb
Rb, Rb, Rb, Rb, Rb, Rb, Ww, Wo, Ww, Gll^Fmf, Rb, Rb, Rb, Gll^Fmf, Rb, Rb, Rb, Gll^Fmf, Gll^Fmf, Rb, Rb, Rb, Rb, Rb, Rb, Md, Md, Md, Gll^Fmf, Md, Hhd, Hhd, Rb, Rb, Ww, Ww, Rb, Rb, Ww, Ww, Rb, Ww, Rb
Rb, Rb, Rb, Rb, Rb, Rb, Gd^Vo, Wo, Ww, Rb, Rb, Rb, Gll^Fmf, Rb, Hhd, Rb, Rb, Rb, Rb, Rb, Hhd, Rb, Md, Rb, Rb, Rb, Hhd, Gll^Fmf, Rb, Hhd, Ww, Ww, Ww, Ww, Rb, Rb, Rb, Gll^Fmf, Ww, Gll^Fmf, Ww, Ww, Ww
Rb, Rb, Rb, Rb, Rb, Rb, Rb, Ww, Wo, Hhd, Hhd, Rb, Rb, Gll^Fmf, Rb, Hhd, Rb, Gd^Vo, Rb, Rb, Hhd, Gll^Fmf, Md, Gll^Fmf, Rb, Rb, Rb, Rb, Rb, Ww, Rb, Rb, Rb, Rb, Re^Vct, Rb, Rb, Gll^Fmf, Ww, Ww, Rb, Rb, Ww
Rb, Rb, Rb, Rb, Hhd, Hhd, Rb, Ww, Wo, Rb, Rb, Rb, Rb, Rb, Gll^Fmf, Rb, Rb, Rb, Rb, Hhd, Md^Xm, Md, Hhd, Gll^Fmf, Rb, Rb, Rb, Rb, Ww, Ww, Rb, Gll^Fmf, Rb, Rb, Rb, Rb, Ww, Ww, Ww, Rb, Ww, Rb, Ww
Rb, Gd^Vo, Gll^Fmf, Rb, Rb, Rb, Gll^Fmf, Ww^Vm, Ww, Ww, Gll^Fmf, Gll^Fmf, Rb, Rb, Rb, Rb, Gll^Fmf, Rb, Rb, Hhd, Gll^Fmf, Gll^Fmf, Rb, Rb, Rb, Rb, Ww, Ww, Rb, Gll^Fmf, Gll^Fmf, Rb, Gll^Fmf, Rb, Rb, Ww, Gll^Fmf, Rb, Rb, Ww, Rb, Ww, Rb
Rb, Rb, Hhd, Gll^Fmf, Rb, Gll^Fmf, Hhd, Rb, Ww, Wo, Ww, Rb, Gd^Vo, Rb, Gll^Fmf, Gll^Fmf, Md^Xm, Rb, Rb, Rb, Rb, Rb, Ce, Rb, Rb, Re^Vct, Ww, Rb, Rb, Rb, Gll^Fmf, Rb, Gll^Fmf, Gll^Fmf, Rb, Ww, Gll^Fmf, Rb, Rb, Rb, Gll^Fmf, Gll^Fmf, Md
Gll^Fmf, Hhd, Rb, Gll^Fmf, Rb, Rb, Rb, Gll^Fmf, Gll^Fmf, Ww, Wo, Ww, Ww, Hhd, Md, Md, Md, Md, Rb, Rb, Rb, Ket, Ket, Rb, Ww, Ww, Rb, Rb, Rb, Rb, Ww, Gll^Fmf, Rb, Rb, Ww, Ww, Rb, Rb, Md, Md, Md^Xm, Md^Xm, Rb
Gll^Fmf, Rb, Rb, Gd^Vo, Rb, Rb, Rb, Rb, Rb, Rb, Gll^Fmf, Wo, Wo, Gll^Fmf, Gll^Fmf, Gll^Fmf, Rb, Rb, Rb, Rb, Rb, Ce, Rb, Ww, Gll^Fmf, Rb, Rb, Rb, Ww, Ww, Rb, Ww, Ww, Ww, Rb, Rb, Gll^Fmf, Rb, Rb, Hhd, Gll^Fmf, Rb, Rb
Gll^Fmf, Rb, Rb, Rb, Gll^Fmf, Gll^Fmf, Rb, Rb, Md, Hhd, Rb, Ww, Ww, Ww, Ww^Vm, Rb, Rb, Rb, Re^Vct, Rb, Ww, Ww, Ww, Ww, Gll^Fmf, Gll^Fmf, Ww, Ww, Rb, Re^Vct, Ww, Ww, Rb, Rb, Md, Gll^Fmf, Hhd, Rb, Rb, Rb, Gll^Fmf, Gll^Fmf, Rb
Gll^Fmf, Gll^Fmf, Rb, Rb, Rb, Rb, Rb, Md, Gll^Fmf, Md^Xm, Gll^Fmf, Hhd, Rb, Wo, Wo, Rb, Rb, Rb, Rb, Ww, Rb, Rb, Rb, Re^Vct, Rb, Rb, Ww, Rb, Ww, Ww, Gll^Fmf, Rb, Rb, Md, Md^Xm, Md^Xm, Md, Rb, Rb, Rb, Rb, Rb, Ww
Gll^Fmf, Gll^Fmf, Rb, Rb, Hhd, Rb, Rb, Hhd, Gll^Fmf, Hhd, Rb, Rb, Rb, Ww, Ww, Wo, Ww, Ww, Ww, Ww, Ww, Ww, Ww, Rb, Rb, Rb, Ww, Ww, Rb, Rb, Rb, Rb, Md^Xm, Hhd, Gll^Fmf, Gll^Fmf, Rb, Rb, Rb, Rb, Rb, Ww, Rb
Rb, Rb, Md, Md, Md, Rb, Rb, Rb, Rb, Rb, Rb, Rb, Rb, Re^Vct, Rb, Wo, Ww, Rb, Rb, Rb, Gll^Fmf, Rb, Ww, Rb, Ww, Ww, Rb, Rb, Gll^Fmf, Md, Rb, Rb, Md, Rb, Rb, Rb, Rb, Rb, Rb, Rb, Re^Vct, Ww, Ww
Gll^Fmf, Hhd, Md^Xm, Md, Hhd, Hhd, Gll^Fmf, Rb, Ket, Ce, Ce, Rb, Rb, Rb, Ww, Ww, Wo, Rb, Rb, Rb, Rb, Rb, Ww, Ww, Gll^Fmf, Rb, Md, Gll^Fmf, Md^Xm, Md^Xm, Rb, Rb, Ce, Rb, Rb, Rb, Gll^Fmf, Rb, Rb, Rb, Ww, Ww, Rb
Gll^Fmf, Gll^Fmf, Gll^Fmf, Hhd, Md^Xm, Gll^Fmf, Md^Xm, Rb, Ce, Ket, Rb, Rb, Ww, Ww, Rb, Ww^Vm, Ww, Ww, Rb, Rb, Ww, Ww, Rb, Gll^Fmf, Rb, Rb, Md, Hhd, Rb, Rb, Rb, Ket, Ket, Rb, Re^Vct, Rb, Ww, Rb, Ww, Ww, Ww, Rb, Ww
Gll^Fmf, Gll^Fmf, Gll^Fmf, Md^Xm, Rb, Rb, Rb, Rb, Rb, Rb, Rb, Re^Vct, Ww, Gll^Fmf, Gll^Fmf, Rb, Ww, Ww, Rb, Re^Vct, Ww, Gll^Fmf, Rb, Gll^Fmf, Hhd, Rb, Rb, Rb, Rb, Rb, Rb, Ce, Rb, Rb, Ww, Ww, Gll^Fmf, Ww, Rb, Rb, Ww, Ww, Rb
Gll^Fmf, Gll^Fmf, Rb, Rb, Rb, Gll^Fmf, Rb, Rb, Ww, Ww, Ww, Ww, Rb, Gll^Fmf, Rb, Rb, Ww, Wo, Wo, Ww, Rb, Md, Md^Xm, Md^Xm, Md, Rb, Rb, Rb, Gll^Fmf, Rb, Ww, Ww, Ww, Ww, Gll^Fmf, Ww, Ww, Ww, Ww, Gll^Fmf, Ww, Gll^Fmf, Rb
Gll^Fmf, Rb, Re^Vct, Rb, Rb, Gll^Fmf, Ww, Ww, Rb, Rb, Gll^Fmf, Rb, Rb, Rb, Re^Vct, Rb, Rb, Ww, Ww, Wo, Wo, Hhd, Gll^Fmf, Gll^Fmf, Rb, Rb, Rb, Rb, Rb, Rb, Ww, Hhd, Hhd, Hhd, Rb, Rb, Rb, Gll^Fmf, Hhd, Ww, Rb, Ww, Ww
Ww, Rb, Rb, Rb, Ww, Rb, Ww, Re^Vct, Rb, Gll^Fmf, Rb, Gll^Fmf, Gll^Fmf, Rb, Rb, Rb, Gll^Fmf, Rb, Ww, Wo, Wo, Ww, Ww, Rb, Rb, Rb, Rb, Rb, Rb, Ww, Rb, Gll^Fmf, Rb, Rb, Re^Vct, Rb, Rb, Hhd, Rb, Rb, Re^Vct, Rb, Rb
Rb, Ww, Ww, Ww, Rb, Ww, Rb, Rb, Ket, Rb, Rb, Rb, Rb, Rb, Rb, Md, Md^Xm, Md^Xm, Ww, Gll^Fmf, Gll^Fmf, Wo, Wo, Ww^Vm, Rb, Gll^Fmf, Gll^Fmf, Rb, Ww, Ww, Gll^Fmf, Gll^Fmf, Rb, Rb, Rb, Rb, Gll^Fmf, Rb, Rb, Rb, Rb, Rb, Rb
Ww, Ww, Ww, Rb, Gll^Fmf, Rb, Rb, Ce, Ce, Ket, Rb, Rb, Hhd, Rb, Rb, Rb, Rb, Gll^Fmf, Rb, Ww, Rb, Gll^Fmf, Ww, Wo, Wo, Rb, Rb, Rb, Ww, Gll^Fmf, Rb, Rb, Rb, Rb, Rb, Gll^Fmf, Rb, Rb, Hhd, Gll^Fmf, Gll^Fmf, Rb, Rb
Rb, Rb, Ww, Rb, Rb, Rb, Re^Vct, Rb, Rb, Rb, Rb, Gll^Fmf, Hhd, Md^Xm, Gll^Fmf, Rb, Rb, Rb, Ww, Ww, Rb, Rb, Re^Vct, Ww, Ww, Wo, Wo, Ww, Rb, Rb, Rb, Rb, Ket, Ce, Rb, Gll^Fmf, Rb, Rb, Gll^Fmf, Gll^Fmf, Rb, Rb, Md^Xm
Ww, Ww, Rb, Gll^Fmf, Gll^Fmf, Rb, Rb, Rb, Rb, Rb, Rb, Md^Xm, Md, Gll^Fmf, Md, Md, Rb, Rb, Ww, Gll^Fmf, Rb, Rb, Rb, Ww, Rb, Wo, Wo, Ww, Ww, Re^Vct, Rb, Ce, Ce, Ket, Rb, Rb, Rb, Rb, Rb, Rb, Gll^Fmf, Gll^Fmf, Hhd
Gll^Fmf, Gll^Fmf, Rb, Gll^Fmf, Gll^Fmf, Gll^Fmf, Rb, Md, Md^Xm, Rb, Rb, Rb, Rb, Rb, Rb, Rb, Rb, Re^Vct, Rb, Ww, Gll^Fmf, Gll^Fmf, Rb, Ww, Rb, Rb, Gll^Fmf, Wo, Wo, Ww, Rb, Rb, Rb, Rb, Re^Vct, Rb, Rb, Md^Xm, Hhd, Hhd, Md, Md^Xm, Hhd
Gll^Fmf, Rb, Re^Vct, Rb, Rb, Rb, Rb, Md^Xm, Gll^Fmf, Md, Rb, Gll^Fmf, Ww, Ww, Ww, Ww, Ww, Rb, Ww, Ww, Ww, Gll^Fmf, Ww, Ww, Rb, Rb, Gll^Fmf, Rb, Ww, Ww, Rb, Rb, Rb, Rb, Rb, Rb, Rb, Rb, Rb, Md, Gll^Fmf, Gll^Fmf, Hhd
Rb, Rb, Md, Rb, Md^Xm, Rb, Rb, Rb, Rb, Rb, Gll^Fmf, Ww, Rb, Re^Vct, Rb, Rb, Rb, Ww, Rb, Rb, Ww, Ww, Gll^Fmf, Gll^Fmf, Rb, Gll^Fmf, Rb, Rb, Ww, Ww, Rb, Gll^Fmf, Gll^Fmf, Rb, Gll^Fmf, Hhd, Hhd, Rb, Rb, Hhd, Rb, Rb, Hhd
Ww, Rb, Md^Xm, Hhd, Md, Rb, Gll^Fmf, Gll^Fmf, Ww, Gll^Fmf, Ww, Ww, Ce, Rb, Rb, Gll^Fmf, Gll^Fmf, Rb, Gll^Fmf, Ww, Rb, Rb, Rb, Rb, Rb, Gll^Fmf, Rb, Rb, Ww^Vm, Wo, Ww, Rb, Gll^Fmf, Hhd, Md, Md, Gll^Fmf, Rb, Rb, Rb, Hhd, Hhd, Rb
Hhd, Ww, Ww, Md^Xm, Ww, Rb, Ww, Ww, Gll^Fmf, Ww, Rb, Ket, Ket, Rb, Rb, Gll^Fmf, Rb, Gll^Fmf, Rb, Ww, Rb, Rb, Rb, Re^Vct, Rb, Rb, Rb, Rb, Rb, Wo, Wo, Ww, Hhd, Md^Xm, Gll^Fmf, Md, Md, Md, Rb, Rb, Rb, Rb, Rb
Md, Rb, Ww, Ww, Rb, Ww, Rb, Gll^Fmf, Rb, Rb, Rb, Ce, Rb, Rb, Gll^Fmf, Rb, Rb, Rb, Rb, Ww, Rb, Gll^Fmf, Gll^Fmf, Rb, Rb, Rb, Md, Rb, Gll^Fmf, Gll^Fmf, Ww, Wo, Wo, Hhd, Rb, Hhd, Hhd, Md, Rb, Rb, Rb, Hhd, Rb
Ww, Ww, Gll^Fmf, Gll^Fmf, Ww, Ww, Gll^Fmf, Rb, Rb, Re^Vct, Rb, Rb, Rb, Rb, Rb, Rb, Gll^Fmf, Rb, Ww, Ww, Rb, Gll^Fmf, Rb, Gll^Fmf, Rb, Rb, Md, Hhd, Md, Rb, Hhd, Ww, Ww, Wo, Ww, Hhd, Hhd, Rb, Rb, Gd^Vo, Rb, Hhd, Rb
Rb, Ww, Ww, Ww, Rb, Gll^Fmf, Rb, Rb, Rb, Rb, Rb, Rb, Gll^Fmf, Rb, Rb, Gll^Fmf, Ww, Ww, Gll^Fmf, Rb, Rb, Rb, Md, Rb, Rb, Rb, Hhd, Md, Gll^Fmf, Hhd, Rb, Rb, Gll^Fmf, Ww, Ww, Rb, Rb, Rb, Rb, Rb, Hhd, Hhd, Rb
Ww, Ww, Ww, Gll^Fmf, Rb, Rb, Gll^Fmf, Rb, Gll^Fmf, Rb, Rb, Gll^Fmf, Rb, Gll^Fmf, Rb, Rb, Ww, Rb, Gll^Fmf, Gll^Fmf, Rb, Md, Gll^Fmf, Md, Rb, Rb, Rb, Gll^Fmf, Rb, Rb, Gd^Vo, Rb, Rb, Ww, Wo, Ww^Vm, Gll^Fmf, Rb, Rb, Hhd, Rb, Rb, Rb
Rb, Rb, Re^Vct, Ww, Ww, Gll^Fmf, Gll^Fmf, Rb, Rb, Gll^Fmf, Rb, Gll^Fmf, Rb, Re^Vct, Rb, Ww, Rb, Rb, Gll^Fmf, Rb, Hhd, Hhd, Md, Md^Xm, Gll^Fmf, Rb, Rb, Rb, Rb, Rb, Rb, Rb, Hhd, Hhd, Wo, Ww, Rb, Gll^Fmf, Hhd, Rb, Rb, Gd^Vo, Rb
Ww, Ww, Ww, Rb, Ww, Ww, Ww, Ww, Ww, Gll^Fmf, Rb, Rb, Gll^Fmf, Rb, Ww, Ww, Rb, Rb, Rb, Rb, Rb, Md, Gll^Fmf, Hhd, Rb, Rb, Hhd, Hhd, Rb, Rb, Rb, Rb, Rb, Hhd, Wo, Ww, Rb, Hhd, Rb, Hhd, Rb, Rb, Rb
Ww, Rb, Ww, Ww, Rb, Rb, Gll^Fmf, Rb, Rb, Ww, Ww, Ww, Ww, Ww, Rb, Rb, Hhd, Hhd, Md, Rb, Rb, Hhd, Rb, Rb, Gll^Fmf, Gd^Vo, Rb, Gll^Fmf, Rb, Rb, Rb, Gll^Fmf, Rb, Rb, Ww, Wo, Gd^Vo, Rb, Rb, Rb, Rb, Rb, Rb
Ww, Ww, Ww, Gll^Fmf, Gll^Fmf, Rb, Rb, Gll^Fmf, Rb, Rb, Ww, Gll^Fmf, Rb, Rb, Hhd, Gll^Fmf, Md, Md^Xm, Hhd, Rb, Gd^Vo, Rb, Rb, Rb, Rb, Rb, Rb, Rb, Rb, Rb, Rb, Gll^Fmf, Rb, Rb, Ww, Wo, Rb, Rb, Rb, Rb, Rb, Rb, Rb
Ww, Rb, Rb, Ww, Ww, Rb, Ww, Rb, Ww, Ww, Gll^Fmf, Gll^Fmf, Rb, Rb, Md, Md^Xm, Hhd, Gll^Fmf, Gll^Fmf, Rb, Rb, Rb, Gll^Fmf, Gll^Fmf, Rb, Rb, Rb, Gll^Fmf, Gll^Fmf, Gll^Fmf, Rb, Rb, Rb, Rb, Ww^Vm, Wo, Ww, Rb, Rb, Rb, Cfr, Rb, Rb
Rb, Ww, Ww, Ww, Re^Vct, Ww, Rb, Ww, Gll^Fmf, Gll^Fmf, Hhd, Hhd, Rb, Rb, Rb, Hhd, Rb, Gll^Fmf, Rb, Rb, Gll^Fmf, Rb, Rb, Rb, Gd^Vo, Rb, Rb, Rb, Rb, Rb, Ww, Ww, Ww, Ww, Rb, Ww, Ww, Ww, Ww, Cfr, 1 Kfr, Cfr, Rb
Ww, Ww, Ww, Rb, Rb, Ww, Rb, Rb, Gll^Fmf, Hhd, Md^Xm, Gll^Fmf, Gll^Fmf, Gll^Fmf, Rb, Rb, Rb, Rb, Rb, Hhd, Hhd, Rb, Rb, Rb, Rb, Rb, Rb, Rb, Ww, Ww, Rb, Rb, Ww, Rb, Rb, Rb, Rb, Wwf, Wwf, Cfr, Cfr, Cfr, Rb
Ww, Gll^Fmf, Ww, Rb, Rb, Ww, Hhd, Hhd, Md, Md, Hhd, Hhd, Md, Md, Rb, Gll^Fmf, Gll^Fmf, Rb, Hhd, Md^Xm, Rb, Rb, Rb, Rb, Rb, Rb, Ww, Ww, Rb, Rb, Ww, Ww, Rb, Ww, Ww, Rb, Rb, Wwf, Wwf, Wwf, Rb, Rb, Rb
