Mm^Xm, Mm^Xm, Mm^Xm, Mm^Xm, Mm^Xm, Mm^Xm, Mm^Xm, Uu, Ur, Uu, Uh, Gg, Gg, Gg, Gg, Gg, Gg, Gg, Gg, Gg, Gg, Gg, Gg, Gg, Ss, Gg, Gg, Gg, Ss, Gg, Ss, Gg, Ss, Ss, Ss, Ss, Ss, Ss, Aa, Aa, Ha, Aa
Mm^Xm, Mm^Xm, Mm^Xm, Mm^Xm, Mm^Xm, Mm^Xm, Uu, Uu^Vu, Ur, Gg, Gg, Gg^Uf, Gg, Hh, Rb, Rb, Chs, Gg, 1 Khs, Gg, Chs, Gg, Rb, Gg, Hh^Fp, Gg, Gg^Fds, Hh^Vhh, Mm, Ss, Gg, Ss, Ce, Hh^Fds, Gg, Gg, Gg, Gg, Rb, Aa, Aa, Ha
Mm^Xm, Mm^Xm, Mm^Xm, Mm^Xm, Uh, Uu, Ur, Ur, Ce, Ke, Gg, Gg, Wwf, Rb, Gg, Chs, Gg, Chs, Gg, Chs, Gg, Chs, Wwrg, Rb, Rb, Rb, Rb, Rb, Rb, Gg, Wwf, Wwf, Wwf, Gg, Wwrg, Gg, Rb, Aa, Ha, Ms^Xm, Aa, Aa^Uf
Mm^Xm, Mm^Xm, Mm^Xm, Mm^Xm, Uu, Uu^Uf, Ur, Gg, Rb, Rb, Wwf, Wwrg, Rb, Wwf, Wwf, Gll^Fp, Wog, Gg, Wwrg, Hh, Gll^Fp, Wwf, Gg, Wwf, Rb, Gg, Wwrg, Gg, Wwf, Wwf, Rb, Gg^Uf, Ss, Wwf, Hh, Wwf, Ai, Ms^Xm, Ms^Xm, Ms^Xm, Aa^Uf, Aa^Uf
Mm^Xm, Mm^Xm, Mm^Xm, Uh, Ur, Uu^Vu, Rb, Rb, Ss, Wwf, Gs^Fds, Gg^Ve, Rb, Chs, Gg, Wwf, Gg^Uf, Wwf, Gg, Wwf, Wog, Wwf, Gg, Chs, Wwf, Wwf, Gg, Wwf, Khs, Gg, Gg, Rb^Vh, Rb, Rb, Gg, Wwf, Ss, Ha^Fpa, Ha, Ms^Xm, Aa^Dr, Aa
Mm^Xm, Mm^Xm, Gg, Ur, Uu, Ur, Gg, Chs, Wwf, Wwrg, Gg, Gs^Fds, Rb, Gg, Mm^Xm, Wwf, Gs^Vc, Gg, Gg, Gg, Gg, Gg, Ss, Wwf, Gg, Rb, Rb, Gg, Gg, Chs, Chs, Gg, Gg, Hh^Fds, Wwf, Wwf, Ai, Aa, Aa, Ms^Xm, Aa, Aa
Mm^Xm, Ce, Ur, Ur, Ss, Wwf, Ss^Bw|, Wwf, Gg^Uf, Gg, Gg, Hh^Fds, Rb, Gg^Dr, Wwf, Wwf, Gg, Hh^Fds, Gg, Gg^Uf, Gg, Gg^Ve, Mm^Xm, Mm, Mm^Xm, Hh, Rb, Ss^Vhs, Dd, Gg, Chs, Dd, Dd, Wwf, Gg, Gg, Ai, Ha, Ha, Ha, Aa, Ha
Gg, Gg, Ss, Wwf, Ur, Gg, Gg, Gg, Wwf, Gg, Mm^Xm, Rb, Dd, Dd, Wwf, Ss, Ss, Gg, Ss^Uf, Gg, Gg, Gg, Ss, Mm, Mm, Gg^Uf, Rb, Ss, Ss, Dd, Chs, Ss, Ss^Bw/, Wwf, Wwf^Bw/, Gg^Bw|, Ss, Ms^Xm, Aa^Fma, Ms^Xm, Ms^Xm, Ms^Xm
Gg, Gg, Wwf, Uu, Gg, Gg, Kd, Gg, Wog, Mm^Xm, Gg, Rb, Dd, Wwf, Gg^Fds, Hh, Ss^Fetd, Ss^Bw\r, Ss, Mm^Xm, Mm^Xm, Gg, Wwf, Mm^Xm, Mm^Xm, Mm, Rb, Mm, Gg, Gg, Khs, Gg, Gg, Ss, Ss^Bw|, Wog, Ai, Ms^Xm, Aa, Ms^Xm, Ms^Xm, Ms^Xm
Gg, Gg, Wwrg, Uu^Uf, Gg, Gg, Cd, Gg, Gg, Wwf, Mm^Xm, Rb, Gg^Dr, Wwf, Wwf, Mm^Xm, Mm^Xm, Hh^Fp, Wog, Ss^Fetd, Mm^Xm, Gg, Gg, Wwf, Wwf, Gg, Gg, Rb, Hh^Fds, Gg, Gg, Gg, Ch, Gg, Gg, Ss, Ms^Xm, Aa^Fma, Ha, Ms^Xm, Ms^Xm, Ms^Xm
Gg, Gg, Wwf, Gg, Mm, Gg, Gg, Cd, Cd, Wwf, Wwf, Rb, Gg, Gg, Ss, Wwf, Mm^Xm, Ss, Ss^Fdw, Hh^Uf, Mm^Xm, Gg, Wwf, Wwf, Mm^Xm, Wwf, Hh^Fds, Rb, Rb, Gg^Uf, Gg, Mm, Gg, Gg, Wwf, Ss, Ai, Ms^Xm, Aa, Ms^Xm, Ms^Xm, Ms^Xm
Gg, Gg, Wog, Gg, Mm, Gg, Hh^Fds, Gg, Gg, Cd, Kd, Wog, Ss, Ss^Bw|r, Gg, Wwf, Gg, Ss, Ss, Mm^Xm, Ss, Gg, Gg, Hh, Mm^Xm, Wwf, Ss, Gg, Wwf, Rb, Rb, Gg, Hh, Ss, Rd, Rb, Aa, Aa^Fma, Ha, Ms^Xm, Ms^Xm, Ms^Xm
Dd, Gg, Wog, Gg, Gg, Gg, Gg^Ve, Gg, Gg, Hh, Gg, Rb, Rb, Gg, Mm^Xm, Wwf, Wwf, Gg, Gg, Gg, Gg, Gg, Hh^Fds, Mm^Xm, Gg, Mm, Hh, Wwf, Ce, Ss, Wwf, Ss, Hh, Mm, Rb, Rb^Ecf, Rb, Aa, Aa^Fma, Ha, Ms^Xm, Ms^Xm
Dd, Gg, Gg, Wwrg, Wwf, Hh, Gg^Uf, Ce, Gg, Gg, Gs^Fds, Gg, Rb, Gg, Gg, Ss^Vhs, Wwf, Hh, Gg, Gs^Vc, Gg^Uf, Wwf, Gg, Gg, Gs^Fds, Gs^Vh, Gg, Gg, Gg, Gg, Wwf, Gs^Vc, Gg, Rd, Rb, Rb, Md^Xm, Ms^Xm, Ms^Xm, Ha, Aa, Aa
Md^Xm, Dd, Dd, Gg, Hh^Fds, Wwf, Wwf, Gg, Gg^Ve, Gg, Gg, Gg^Uf, Rb, Ss, Ss, Gg, Wwf, Gg, Wwf, Gs^Fds, Gg, Wwf, Ss, Gg, Gg, Gg, Gg, Chw, Wwf, Wwrg, Gg, Rb, Rb, Hh^Fds, Ha, Ha, Ha, Aa, Ha^Fpa, Ms^Xm, Aa^Uf, Aa^Uf
Md^Xm, Dd^Edpp, Dd, Dd, Gg, Gg, Gg, Wwf^Bw/, Wwrg, Gg, Gg^Uf, Gg, Rb, Cd, Gg, Hh, Wwf, Wwrg, Gg, Wwf, Wwrg, Gg, Gg, Cd, Gg, Gg, Wwf, Khw, Ss, Hh, Gg, Ss, Hh, Rb, Rb, Gg, Gg, Gg, Ms^Xm, Ms^Xm, Aa, Aa^Uf
Md^Xm, Md^Xm, Dd, Dd^Edp, Dd, Hh, Gg, Gg, Gg, Wwf, Wwf, Wwf, Wog, Wwf, Wwf, Wwf, Cd, Gg, Gg, Gg, Cd, Wwf, Wwf, Gg, Ss, Wwf, Gg, Wwf, Gg, Gg, Gg, Gg, Gg, Gg, Gg, Rb, Rb, Ms^Xm, Rb, Ms^Xm, Aa^Dr, Aa
Md^Xm, Md^Xm, Md^Xm, Dd, Md^Xm, Dd, Dd, Cd, Dd, Hh, Gg, Gs^Fds, Gg, Gg, Hh^Fp, Cd, Gg, Cd, 2 Kd, Cd, Gs^Vc, Cd, Gg, Wog, Hh, Gll^Fp, Gll^Fp, Gg, Gg^Uf, Gg^Ve, Hh, Gg, Ss, Gg, Hh^Fds, Ss, Hh^Fds, Rb, Gg, Aa, Aa^Uf, Ha
Md^Xm, Md^Xm, Md^Xm, Md^Xm, Md^Xm, Md^Xm, Md^Xm, Dd, Dd, Dd, Dd, Gg, Gg, Gg, Gg, Gg, Gg, Gg, Gg, Gg, Gg, Gg, Gg, Hh, Gg, Gg, Gg, Gg, Gg, Gg, Hh, Hh, Hh, Hh, Hh, Hh, Gg, Hh, Aa, Aa, Aa^Uf, Aa^Uf
