border_size=1
usage=map

_off^_usr          , _off^_usr          , _off^_usr          , _off^_usr          , _off^_usr          , _off^_usr          , _off^_usr          , _off^_usr          , _off^_usr          , _off^_usr          , _off^_usr          , _off^_usr          , _off^_usr          , _off^_usr          , _off^_usr          , _off^_usr          , _off^_usr          , _off^_usr          , _off^_usr          , _off^_usr          , _off^_usr          , _off^_usr          , _off^_usr          , _off^_usr          , _off^_usr          , _off^_usr          , _off^_usr          , _off^_usr          , _off^_usr          , _off^_usr          , _off^_usr          , _off^_usr          , _off^_usr          , _off^_usr          , _off^_usr          , _off^_usr          , _off^_usr          
_off^_usr          , _off^_usr          , _off^_usr          , _off^_usr          , _off^_usr          , _off^_usr          , Wwf         , Uu          , Uu          , Gll^Fp      , Gs          , Gg          , Hh          , Hh^Tf       , Wwg         , Wwg         , Wwg         , Ch          , 1 Kh        , Ch          , Gs          , Gd^Vo       , Re^Tf       , Hh^Fms      , Wwf         , Wwf         , Wwf         , Wwg         , Wwg         , Ss          , Ss          , _off^_usr          , _off^_usr          , _off^_usr          , _off^_usr          , _off^_usr          , _off^_usr          
_off^_usr          , _off^_usr          , _off^_usr          , _off^_usr          , Uh          , Uu          , Wwf         , Uu^Tf       , Uu          , Sm          , Gs          , Gs          , Gd          , Mm          , Gs^Fds      , Wwg         , Wwf         , Ch          , Ch          , Ch          , Gs          , Gs^Fds      , Wwf         , Wwf         , Gd          , Gs          , Gg          , Wwf         , Gd^Fmw      , Ds^Tf       , Gs          , Hh^Fms      , Rb          , _off^_usr          , _off^_usr          , _off^_usr          , _off^_usr          
_off^_usr          , _off^_usr          , Rb          , Rb          , Wwf         , Wwf         , Uu          , Wwf         , Wwf         , Gs          , Gs^Fms      , Gs          , Gs          , Gs          , Gs          , Gg          , Gs          , Wwf         , Gg          , Gs          , Gs          , Gs          , Wwf         , Hh          , Rb^Tf       , Gs          , Gs          , Gd          , Gd          , Gs          , Rb          , Rb          , Gs^Fms      , Rb          , Rb          , _off^_usr          , _off^_usr          
_off^_usr          , Rb          , Uu^Tf       , Uu          , Wwf         , Uu          , Uh          , Uu          , Wwf         , Gs          , Gg          , Gs          , Gg          , Gd^Vht      , Gg          , Gs          , Gs^Fms      , Wwf         , Gs          , Hh          , Wwf         , Wwf         , Gd          , Rb^Vhc      , Gll         , Hh^Fds      , Mm          , Gll         , Gs          , Ss          , Rb          , Ss          , Hh          , Ss          , Ss          , Rb          , _off^_usr          
_off^_usr          , Rb          , Wwf         , Wwf         , Gd^Fmw      , Sm          , Gd          , Gd          , Gs          , Wwf         , Gd          , Gs          , Wwf         , Gg          , Gg          , Gg          , Wwf         , Wwr         , Wwf         , Wwf         , Gd          , Gd          , Gll         , Gd          , Gg          , Hh          , Gs          , Gs          , Gs^Vl       , Rb          , Gs^Fds      , Ss          , Gs          , Gs^Fet      , Ds^Tf       , Rb          , _off^_usr          
_off^_usr          , Rb          , Wwf         , Gg          , Gs          , Gs          , Rb^Vhcr     , Gs          , Gs^Fet      , Wwf         , Wwf         , Wwf         , Hh          , Wwf         , Wwf         , Gs^Fdw      , Wwg         , Hh^Vc       , Mm          , Gd^Fmw      , Gs          , Gs          , Gs          , Gg          , Gs          , Gg          , Gs          , Gd^Fp       , Hh^Fms      , Ss          , Gs          , Gd^Fmw      , Gg          , Gs          , Gs          , Gg          , _off^_usr          
_off^_usr          , Gd          , Wwf         , Gd          , Hh^Fp       , Gg          , Gg          , Gs^Fdw      , Ce          , Ket         , Ce          , Wwg         , Gs^Fds      , Rd^Tf       , Wwf         , Wwf         , Hh^Fds      , Wwg         , Wwf         , Gs          , Gg          , Gg          , Hh          , Ss          , Gll^Tf      , Gs          , Ce          , Ke          , Ce          , Gg          , Gs          , Gs          , Hh^Fp       , Gs          , Hh          , Gs          , _off^_usr          
_off^_usr          , Gs          , Wwg         , Mm^Xm       , Mm^Xm       , Mm          , Ss          , Gs          , Gg          , Ce          , Gs          , Ss          , Mm^Xm       , Hh^Vd       , Hh^Fms      , Wwf         , Wwf         , Wwf         , Gs          , Wwf         , Wwf         , Gd^Vhr      , Mm^Xm       , Mm^Xm       , Mm^Xm       , Gg          , Gs          , Ce          , Gg          , Gs          , Gd          , Hh          , Mm^Xm       , Mm^Xm       , Wwf         , Gg          , _off^_usr          
_off^_usr          , Gs          , Wwg         , Wwg         , Mm^Xm       , Ss          , Gll^Tf      , Gs          , Gs          , Gs          , Gs^Fms      , Mm^Xm       , Rb^Tf       , Mm          , Wwf         , Wwf         , Gll^Fp      , Gs          , Gs          , Gd          , Gd          , Wwf         , Wwf         , Mm          , Gs          , Wwg^Vhs     , Gs^Fet      , Gs          , Gs          , Gs          , Wwf         , Wwg         , Mm^Xm       , Wwf         , Hh^Fms      , Gg          , _off^_usr          
_off^_usr          , Gg          , Gd^Fmw      , Wwg         , Gd          , Gg          , Gs          , Gs          , Gs          , Gs^Fds      , Mm          , Mm^Xm       , Wwf         , Hh          , Wwf         , Wwf         , Gd          , Gd          , Gs          , Gll         , Gs          , Hh^Fp       , Wwf         , Gs          , Wwf         , Wwf         , Wwg         , Gs          , Wwg         , Gs          , Wwf         , Gll^Fp      , Wwf         , Wwf         , Gg          , Gs          , _off^_usr          
_off^_usr          , Gd          , Gd          , Gg          , Hh          , Gll         , Gs^Fms      , Gg          , Gs          , Gg          , Wwf         , Wwf         , Gd^Fp       , Wwf         , Wwf         , Gs          , Gs          , Gll         , Mm^Xm       , Hh          , Gd          , Gd^Fmw      , Wwf         , Wwf         , Wwr         , Gs^Fds      , Wwf         , Wwg         , Gg          , Wwg         , Hh^Fds      , Wwf         , Hh          , Gs          , Gs          , Gd          , _off^_usr          
_off^_usr          , Gd          , Gd          , Rb^Tf       , Hh          , Mm          , Hh^Fds      , Gs          , Gs          , Gs          , Wwf         , Hh          , Wwr         , Hh^Fp       , Wwf         , Gd          , Gg          , Hh^Tf       , Mm^Xm       , Hh^Tf       , Gs          , Gd          , Wwf         , Hh^Fms      , Gs^Fp       , Hh          , Wwf         , Gs          , Gd          , Gd          , Gs^Fdw      , Mm          , Hh          , Rb^Tf       , Gs          , Gg          , _off^_usr          
_off^_usr          , Gs          , Gs          , Gs          , Wwf         , Wwf         , Wwf         , Wwg         , Wwg         , Wwg         , Wwg         , Gs^Fet      , Wwf         , Wwf         , Wwf         , Gs^Fds      , Gg          , Hh          , Gs          , Gd          , Gg          , Gs          , Wwf         , Wwf         , Wwf         , Wwf         , Mm          , Gs          , Gs          , Gs          , Gd          , Gd          , Gg          , Gs          , Gs^Fds      , Gg          , _off^_usr          
_off^_usr          , Gg          , Hh^Fp       , Wwf         , Mm^Xm       , Gs^Fet      , Wwf         , Gs          , Gs          , Gd          , Gd^Fmw      , Wwf         , Gs          , Gs          , Wwf         , Hh^Fms      , Gs          , Gd          , Gd          , Gg          , Gs^Fms      , Wwf         , Wwf         , Hh          , Rb^Tf       , Mm^Xm       , Gs^Fds      , Gd^Fmw      , Gs          , Gg          , Gll^Tf      , Gg          , Mm^Xm       , Wwg         , Wwg         , Gd          , _off^_usr          
_off^_usr          , Gg          , Wwf         , Wwf         , Mm^Xm       , Wwg         , Gg          , Gs          , Gd          , Gd          , Gs          , Wwg^Vhs     , Mm^Xm       , Mm          , Mm^Xm       , Wwf         , Wwf         , Gg          , Gg          , Gg          , Wwf         , Wwf         , Hh^Fds      , Mm          , Mm^Xm       , Mm^Xm       , Gg          , Gg          , Gg          , Gd          , Ss          , Ss          , Mm^Xm       , Wwg         , Wwg         , Gs          , _off^_usr          
_off^_usr          , Gs          , Hh          , Mm^Xm       , Hh^Fms      , Hh          , Gd          , Gs          , Ce          , Ce          , Ce          , Gs          , Gll^Tf      , Mm^Xm       , Hh          , Gd^Vhr      , Gs          , Wwf         , Wwf         , Wwf         , Hh^Fp       , Wwf         , Wwf         , Hh^Vd       , Gll^Fp      , Ss          , Ce          , Ce          , Ce          , Gs          , Gs          , Mm          , Hh^Fds      , Mm^Xm       , Wwf         , Gg          , _off^_usr          
_off^_usr          , Gs          , Gs          , Gs          , Gd          , Gs          , Gs          , Gd          , Hh^Fp       , Ke          , Gs          , Gs          , Gd          , Ss          , Gll         , Gs          , Gll         , Gd          , Mm          , Wwg         , Wwg         , Wwf         , Wwf         , Rd^Tf       , Hh          , Wwg         , Wwf         , Ket         , Gs^Fms      , Gll^Fp      , Gd^Vht      , Gs          , Gs          , Gg          , Wwf         , Gg          , _off^_usr          
_off^_usr          , Gg          , Ds^Tf       , Gg          , Gg          , Gd^Fmw      , Gs^Fds      , Ss          , Gd^Vc       , Gs^Fdw      , Gd          , Gd          , Gs          , Gs          , Gs          , Gll         , Gs          , Gll^Fp      , Wwf         , Hh^Vo       , Wwf         , Gs^Fms      , Gs          , Wwf         , Wwf         , Wwf         , Gd          , Wwf         , Gd          , Gd          , Gs          , Gg          , Gd^Fmw      , Gs          , Wwf         , Gg          , _off^_usr          
_off^_usr          , Rb          , Ss          , Gs^Fdw      , Hh          , Ss          , Rb          , Rb          , Gg          , Gd          , Mm          , Hh          , Gll         , Gd          , Gs          , Gd          , Wwf         , Wwf         , Gs          , Wwr         , Gd^Fmw      , Gs          , Gs          , Gd          , Gd          , Gs          , Gs          , Wwf         , Wwf         , Gs          , Uh          , Sm          , Uu          , Wwf         , Uu^Tf       , Rb          , _off^_usr          
_off^_usr          , Rb          , Rb          , Ss          , Gs^Fms      , Ss          , Rb          , Ss          , Gg          , Gs          , Gs          , Hh^Fds      , Rb^Tf       , Rb^Vhcr     , Wwf         , Wwf         , Gd          , Hh          , Gs          , Wwf         , Gd          , Gll         , Gll         , Gd^Vhc      , Gd          , Gs          , Gs^Fdw      , Gs          , Wwf         , Uu          , Uu          , Uu          , Wwf         , Wwf         , Rb          , Rb          , _off^_usr          
_off^_usr          , _off^_usr          , _off^_usr          , Rb          , Rb          , Rb          , Gs          , Gs          , Gd^Fmw      , Gd          , Gs          , Gd          , Gs          , Hh          , Wwf         , Gs          , Gs          , Gg          , Ch          , Wwf         , Wwf         , Gd          , Gs^Fet      , Gg          , Gd          , Gd          , Gs          , Gs          , Uu          , Wwf         , Wwf         , Wwf         , Uh          , Rb          , _off^_usr          , _off^_usr          , _off^_usr          
_off^_usr          , _off^_usr          , _off^_usr          , _off^_usr          , _off^_usr          , Hh^Fp       , Ss          , Ds^Tf       , Wwg         , Wwf         , Wwf         , Gs          , Wwf         , Wwf         , Re^Tf       , Gll^Fp      , Gg          , Ch          , 2 Kh        , Ch          , Wwg         , Wwg         , Wwg         , Mm          , Hh          , Gll         , Gd          , Sm          , Uu          , Uu^Tf       , Wwf         , Uu          , _off^_usr          , _off^_usr          , _off^_usr          , _off^_usr          , _off^_usr          
_off^_usr          , _off^_usr          , _off^_usr          , _off^_usr          , _off^_usr          , _off^_usr          , _off^_usr          , Ss          , _off^_usr          , Wwg         , _off^_usr          , Wwf         , _off^_usr          , Hh^Fms      , _off^_usr          , Gd^Vl       , _off^_usr          , Ch          , _off^_usr          , Ch          , _off^_usr          , Wwg         , _off^_usr          , Hh^Tf       , _off^_usr          , Gd          , _off^_usr          , Gll^Fp      , _off^_usr          , Uu          , _off^_usr          , _off^_usr          , _off^_usr          , _off^_usr          , _off^_usr          , _off^_usr          , _off^_usr          
_off^_usr          , _off^_usr          , _off^_usr          , _off^_usr          , _off^_usr          , _off^_usr          , _off^_usr          , _off^_usr          , _off^_usr          , _off^_usr          , _off^_usr          , _off^_usr          , _off^_usr          , _off^_usr          , _off^_usr          , _off^_usr          , _off^_usr          , _off^_usr          , _off^_usr          , _off^_usr          , _off^_usr          , _off^_usr          , _off^_usr          , _off^_usr          , _off^_usr          , _off^_usr          , _off^_usr          , _off^_usr          , _off^_usr          , _off^_usr          , _off^_usr          , _off^_usr          , _off^_usr          , _off^_usr          , _off^_usr          , _off^_usr          , _off^_usr          
