border_size=1
usage=map

Qxe         , Qxe         , Qxe         , Qxe         , Qxe         , Qxe         , Qxe         , Qxe         , Qxe         , Qxe         , Qxe         , Qxe         , Qxe         , Qxe         , Qxe         , Qxe         , Qxe         , Qxe         , Qxe         , Qxe         , Qxe         , Qxe         , Qxe         , Qxe         , Qxe         , Qxe         , Qxe         , Qxe         , Qxe         , Qxe         , Qxe         , Qxe         , Qxe         , Qxe         , Qxe         , Qxe         , Qxe         , Qxe         , Qxe         , Qxe         , Qxe         , Qxe         , Qxe         , Qxe         , Qxe         , Qxe         , Qxe         , Qxe         , Qxe         , Qxe         , Qxe         , Qxe         
Qxe         , Qxe         , Qxe         , Qxe         , Qxe         , Qxe         , Qxe         , Qxe         , Qxe         , Qxe         , Qxe         , Qxe         , Qxe         , Qxe         , Qxe         , Qxe         , Qxe         , Qxe         , Qxe         , Qxe         , Xuc         , Qxe         , Xuc         , Qxe         , Qxe         , Qxe         , Qxe         , Qxe         , Urb         , Qxe         , Qxe         , Qxe         , Qxe         , Qxe         , Qxe         , Qxe         , Qxe         , Qxe         , Qxe         , Qxe         , Qxe         , Qxe         , Qxe         , Qxe         , Qxe         , Qxe         , Qxe         , Qxe         , Qxe         , Qxe         , Qxe         , Qxe         
Qxe         , Qxe         , Qxe         , Qxe         , Qxe         , Qxe         , Qxe         , Qxe         , Urb         , Qxe         , Qxe         , Urb         , Qxe         , Qxe         , Urb         , Qxe         , Qxe         , Qxe         , Xuc         , Xuc         , Md          , Xuc         , Qxu         , Xuc         , Qxe         , Urb         , Qxe         , Qxe         , Qxe         , Qxe         , Qxe         , Urb         , Qxe         , Qxe         , Urb         , Urb         , Qxe         , Qxe         , Qxe         , Qxe         , Qxe         , Qxe         , Qxe         , Qxe         , Urb         , Qxe         , Qxe         , Urb         , Qxe         , Qxe         , Qxe         , Qxe         
Qxe         , Qxe         , Qxe         , Qxe         , Urb         , Qxe         , Qxe         , Urb         , Qxe         , Urb         , Qxe         , Qxe         , Qxe         , Urb         , Qxe         , Qxe         , Xuc         , Xuc         , Urb         , Uu^Uf       , Cud         , Cud         , Kud         , Xuc         , Xuc         , Qxe         , Xu          , Xu          , Xu          , Xu          , Xu          , Qxe         , Qxe         , Qxe         , Urb         , Qxe         , Urb         , Qxe         , Urb         , Urb         , Urb         , Qxe         , Urb         , Urb         , Qxe         , Urb         , Qxe         , Qxe         , Qxe         , Qxe         , Qxe         , Qxe         
Qxe         , Qxe         , Qxe         , Urb         , Qxe         , Urb         , Qxe         , Urb         , Urb         , Urb         , Qxe         , Urb         , Qxe         , Qxe         , Qxe         , Qxe         , Xuc         , Uu          , Urb         , Urb         , Urb         , Cud         , Urb         , Wwf         , Urb         , Xuc         , Ur          , Uu          , Ur          , Ai          , Qxua        , Xu          , Xu          , Qxe         , Qxe         , Urb         , Qxe         , Qxe         , Qxe         , Qxe         , Qxe         , Qxe         , Qxe         , Urb         , Qxe         , Urb         , Urb         , Urb         , Qxe         , Qxe         , Qxe         , Qxe         
Qxe         , Qxe         , Qxe         , Urb         , Urb         , Qxe         , Urb         , Qxe         , Urb         , Qxe         , Qxe         , Qxe         , Xu          , Xu          , Xu          , Xu          , Cud         , Uu          , Urb         , Urb         , Uu^Vud      , Urb         , Urb         , Urb         , Urb         , Ur          , Ur          , Ur          , Ur          , Ai          , Ai          , Qxua        , Qxua        , Xu          , Xu          , Qxu         , Xu          , Qxe         , Qxe         , Qxe         , Qxe         , Qxe         , Urb         , Urb         , Qxe         , Qxe         , Qxe         , Qxe         , Qxe         , Qxe         , Qxe         , Qxe         
Qxe         , Qxe         , Qxe         , Qxe         , Urb         , Qxe         , Urb         , Qxe         , Urb         , Qxe         , Qxe         , Xu          , Hhd         , Hhd^Fdw     , Ur          , Ur          , Ur          , Ur          , Xu          , Uu          , Qxu         , Uu          , Xu          , Xu          , Xu          , Uh          , Xu          , Xu          , Xu          , Ur          , Uu          , Ai          , Xu          , Xu          , Qxu         , Xu          , Qxu         , Xu          , Xu          , Qxe         , Xu          , Qxe         , Qxe         , Qxe         , Qxe         , Qxe         , Qxe         , Qxe         , Urb         , Qxe         , Qxe         , Qxe         
Qxe         , Qxe         , Qxe         , Urb         , Qxe         , Qxe         , Qxe         , Urb         , Qxe         , Qxe         , Xu          , Xu          , Ur          , Ur          , Ur^Uf       , Ur          , Uh          , Uh          , Wwf         , Xu          , Xu          , Xu          , Re          , Rd          , Re          , Xu          , Re          , Hhd         , Re          , Ur          , Xu          , Uh          , Xu          , Qxu         , Ch          , Qxu         , Ch          , Qxu         , Qxu         , Xu          , Uu^Vu       , Xu          , Qxe         , Qxe         , Urb         , Urb         , Urb         , Qxe         , Qxe         , Qxe         , Qxe         , Qxe         
Qxe         , Qxe         , Urb         , Urb         , Urb         , Qxe         , Qxe         , Qxe         , Xu          , Xu          , Wwf         , Uu          , Ur          , Wwf         , Xu          , Qxu         , Wwf         , Wwf         , Wwg         , Wwf         , Wwf         , Wwf         , Wwf         , Hhd         , Rb          , Rb          , Re          , Ke          , Ce          , Rd          , Rd          , Xu          , Rb^Uf       , Wwf         , Wwf         , 2 Kh        , Urb         , Ch          , Qxu         , Ur          , Xu          , Xu          , Qxe         , Urb         , Urb         , Qxe         , Qxe         , Urb         , Qxe         , Qxe         , Qxe         , Qxe         
Qxe         , Qxe         , Urb         , Qxe         , Urb         , Qxe         , Qxe         , Qxe         , Xu          , Wog         , Wwf         , Rb          , Xu          , Xu          , Wwf         , Wwf         , Ds          , Rd          , Rd          , Rd          , Rb          , Rb          , Gd^Fdf      , Wwf         , Wwf         , Hhd^Fdf     , Md          , Rd          , Rd          , Rd          , Rb          , Re^Uf       , Re          , Re          , Wwf         , Ch          , Ch          , Ch          , Qxu         , Urb         , Xu          , Qxe         , Urb         , Qxe         , Urb         , Urb         , Urb         , Urb         , Urb         , Qxe         , Qxe         , Qxe         
Qxe         , Qxe         , Qxe         , Qxe         , Qxe         , Qxe         , Xu          , Xu          , Rb          , Wwf         , Rb          , Rb          , Xu          , Qxu         , Wwf         , Ds          , Dd^Dr       , Rd          , Rd          , Xu          , Xu          , Xu          , Gd          , Gd          , Gd^Vhr      , Wwf         , Wwf         , Re^Vct      , Rb          , Re          , Wwf         , Wwf         , Wwf         , Wwf         , Urb         , Urb         , Urb         , Urb         , Urb         , Urb         , Xu          , Qxe         , Qxe         , Urb         , Qxe         , Qxe         , Urb         , Qxe         , Urb         , Qxe         , Qxe         , Qxe         
Qxe         , Qxe         , Qxe         , Urb         , Qxe         , Qxe         , Xu          , Rb          , Wwf         , Wwf         , Gd^Fmw      , Rb          , Uu          , Xu          , Wwf         , Ds          , Ds          , Dd          , Rd          , Hhd         , Re          , Gll         , Wwf         , Gd          , Gll^Fp      , Gs          , Ds          , Wwf         , Wwf         , Wwf         , Xu          , Xu          , Xu          , Md          , Xu          , Xu          , Xu          , Urb         , Uu^Vud      , Urb         , Urb         , Xu          , Xu          , Qxe         , Urb         , Urb         , Qxe         , Urb         , Qxe         , Qxe         , Qxe         , Qxe         
Qxe         , Qxe         , Qxe         , Qxe         , Qxe         , Xu          , Rb          , Rb          , Wwf         , Xuc         , Rb          , Rb          , Rb          , Xu          , Xu          , Wwf         , Rd          , Rd          , Rd          , Re^Vct      , Gll         , Gll         , Wwg         , Gs          , Sm          , Gs          , Gs          , Wwf         , Hhd^Fdf     , Hhd         , Gg^Efm      , Ss          , Gg          , Xu          , Gg          , Md          , Gg^Efm      , Xu          , Xu          , Urb         , Uh          , Urb         , Urb         , Xu          , Qxe         , Qxe         , Qxe         , Qxe         , Qxe         , Qxe         , Qxe         , Qxe         
Qxe         , Qxe         , Qxe         , Qxe         , Qxe         , Xu          , Wwf         , Wwf         , Uu^Vud      , Rb          , Rb          , Rb          , Uh          , Rb          , Xu          , Wwf         , Rb          , Dd^Dc       , Re          , Rb^Uf       , Gll^Fmf     , Sm          , Gll         , Wwf         , Gs          , Gs          , Gs          , Wwf         , Gg          , Gg^Efm      , Gd^Vo       , Gg          , Gg          , Gg^Efm      , Ce          , Gg^Efm      , Gg^Efm      , Gs^Ft       , Xu          , Qxu         , Xuc         , Urb         , Urb         , Xuc         , Xuc         , Qxe         , Qxe         , Qxe         , Qxe         , Qxe         , Qxe         , Qxe         
Qxe         , Qxe         , Qxe         , Urb         , Qxe         , Xu          , Xu          , Uu^Uf       , Ur          , Ur          , Ur          , Xu          , Ss          , Gll^Fp      , Wwf         , Wwf         , Sm          , Rb          , Xu          , Re          , Md          , Gll         , Wwf         , Wwf         , Gs^Fds      , Hh^Fds      , Wwf         , Wwf         , Wwf         , Gg          , Gg^Efm      , Gs^Ft       , Gg^Efm      , Gg          , Ce          , Ke          , Gg          , Gg          , Uu^Uf       , Xuc         , Uu^Vu       , Urb         , Wwg         , Urb         , Urb         , Xuc         , Xuc         , Qxe         , Qxe         , Qxe         , Qxe         , Qxe         
Qxe         , Qxe         , Urb         , Urb         , Qxe         , Qxe         , Xuc         , Uu          , Ur          , Ur          , Ur^Uf       , Xu          , Xu          , Gll         , Wwf         , Rb          , Rb          , Rb          , Xu          , Gs          , Gs          , Gs          , Wwf         , Hh          , Wwrg        , Wwf         , Xu          , Xu          , Xu          , Wwf         , Gg^Uf       , Gg^Efm      , Gg          , Gg          , Gs^Fds      , Hh          , Xu          , Uu          , Ur          , Xuc         , Gll^Fp      , Urb         , Urb         , Cud         , Cud         , Uue         , Xuc         , Qxe         , Qxe         , Qxe         , Qxe         , Qxe         
Qxe         , Qxe         , Qxe         , Qxe         , Xuc         , Xuc         , Uue         , Xuc         , Cud         , Ur          , Ur          , Wwf         , Ur          , Xu          , Xu          , Wwf         , Wwf         , Wwf         , Wwf         , Ds          , Gg          , Gs          , Gg          , Wwf         , Xu          , Xu          , Xu          , Wog         , Wwf         , Wwf         , Wwg         , Gg^Efm      , Hh^Fms      , Wwf         , Gs^Fds      , Ss          , Xu          , Ur          , Ur          , Xuc         , Ur          , Urb         , Urb         , Urb         , Kud         , Uue         , Xuc         , Qxe         , Qxe         , Qxe         , Qxe         , Qxe         
Qxe         , Qxe         , Qxe         , Qxe         , Xuc         , Uue         , Kud         , Urb         , Urb         , Ur          , Ur          , Ur          , Ur          , Dd^Dc       , Xu          , Gg^Uf       , Gs^Fds      , Gs^Fds      , Hh^Fms      , Wwf         , Wwg         , Ss          , Wwf         , Wwf         , Xu          , Qlf         , Xu          , Wwf         , Gg          , Ss          , Gg          , Wwf         , Wwf         , Gs^Fds      , Wwf         , Gg^Uf       , Xu          , Dd^Dc       , Ur          , Ur          , Ur          , Ur          , Cud         , Urb         , Uue         , Uue         , Xuc         , Qxe         , Urb         , Qxe         , Qxe         , Qxe         
Qxe         , Qxe         , Qxe         , Qxe         , Xuc         , Uue         , Cud         , Urb         , Urb         , Urb         , Gll^Fp      , Xuc         , Ur          , Ur          , Xu          , Ss          , Gs^Fds      , Wwf         , Gg^Efm      , Gg          , Gg^Uf       , Wwf         , Xu          , Wog         , Xu          , Xu          , Wwrg        , Wwf         , Wwf         , Gs          , Gs          , Ds          , Xu          , Wwf         , Rb          , Wwf         , Wwf         , Xu          , Xu          , Wwf         , Ur^Uf       , Ur          , Ur          , Xuc         , Xuc         , Xuc         , Qxe         , Qxe         , Qxe         , Qxe         , Qxe         , Qxe         
Qxe         , Qxe         , Qxe         , Qxe         , Xuc         , Uue         , Urb         , Cud         , Wwg         , Urb         , Uu^Vu       , Xuc         , Uu^Uf       , Uu          , Gg          , Hh          , Ce          , Gg^Efm      , Gg^Efm      , Gg          , Gg          , Wwf         , Wwf         , Xu          , Wwf         , Wwf         , Gs^Fds      , Hh          , Wwf         , Gs          , Md          , Gs          , Xu          , Rb          , Sm          , Rb          , Wwf         , Gll         , Ss          , Xu          , Ur          , Ur          , Ur          , Ur          , Xu          , Qxe         , Qxe         , Qxe         , Urb         , Qxe         , Qxe         , Qxe         
Qxe         , Qxe         , Qxe         , Qxe         , Qxe         , Xuc         , Xuc         , Urb         , Urb         , Urb         , Xuc         , Xuc         , Xu          , Gg^Efm      , Gg          , Ke          , Ce          , Gg          , Gg          , Gs^Ft       , Gd^Vo       , Gg^Efm      , Gg          , Wwf         , Gs          , Hh^Fds      , Gs          , Wwf         , Gll         , Gll         , Gll^Fmf     , Re          , Re          , Rb          , Rb          , Wwf         , Xu          , Gll^Fp      , Uh          , Xu          , Rb          , Ur          , Uu^Vud      , Uu^Uf       , Wwf         , Xu          , Qxe         , Urb         , Urb         , Qxe         , Qxe         , Qxe         
Qxe         , Qxe         , Qxe         , Urb         , Qxe         , Qxe         , Qxe         , Xuc         , Urb         , Urb         , Uh          , Qxu         , Xu          , Gs^Ft       , Gg          , Gg^Efm      , Gg^Efm      , Gg^Efm      , Gg          , Gg          , Gg          , Gg^Efm      , Hhd^Fdf     , Wwf         , Gs          , Gs          , Sm          , Wwf         , Wwg         , Sm          , Gll         , Rb^Uf       , Rd          , Dd^Dc       , Rd          , Wwf         , Xu          , Rb          , Rb          , Rb          , Rb          , Rb          , Wwf         , Wwf         , Rb          , Xu          , Qxe         , Qxe         , Qxe         , Qxe         , Qxe         , Qxe         
Qxe         , Qxe         , Urb         , Urb         , Urb         , Qxe         , Qxe         , Xu          , Xu          , Urb         , Urb         , Urb         , Uu^Vud      , Xu          , Xu          , Md          , Xu          , Xu          , Xu          , Ss          , Xu          , Hhd         , Wwf         , Wwf         , Ds          , Gg          , Gll^Fp      , Gs          , Wwf         , Gll         , Re          , Re^Vct      , Rd          , Rd          , Ds          , Wwf         , Wwf         , Xu          , Uu          , Rb          , Gd^Fmw      , Xuc         , Wwf         , Rb          , Xu          , Xu          , Qxe         , Qxe         , Qxe         , Qxe         , Qxe         , Qxe         
Qxe         , Qxe         , Urb         , Qxe         , Qxe         , Urb         , Qxe         , Qxe         , Qxe         , Xu          , Xu          , Urb         , Urb         , Urb         , Urb         , Xu          , Urb         , Md          , Wwf         , Xu          , Wwf         , Wwf         , Rb          , Wwf         , Wwf         , Gs          , Gd^Vhr      , Gd          , Gd          , Gll         , Xu          , Hhd         , Rd          , Dd          , Dd^Dr       , Ds          , Wwf         , Xu          , Xu          , Rb          , Rb          , Wwf         , Rb          , Rb          , Xu          , Qxe         , Urb         , Qxe         , Qxe         , Qxe         , Qxe         , Qxe         
Qxe         , Qxe         , Qxe         , Urb         , Qxe         , Urb         , Qxe         , Urb         , Qxe         , Qxe         , Xu          , Urb         , Qxu         , Urb         , Ch          , Urb         , Wwf         , Wwf         , Re          , Wwf         , Rb          , Re          , Rd          , Re^Vct      , Md          , Wwf         , Wwf         , Gd          , Gd^Fdf      , Xu          , Rb          , Xu          , Rd          , Rd          , Ds          , Ds          , Wwf         , Qxu         , Xu          , Rb          , Wwf         , Wwf         , Xu          , Xu          , Qxe         , Qxe         , Urb         , Qxe         , Qxe         , Qxe         , Qxe         , Qxe         
Qxe         , Qxe         , Qxe         , Urb         , Qxe         , Qxe         , Qxe         , Urb         , Qxe         , Qxe         , Xu          , Urb         , Qxu         , Ch          , Urb         , Ch          , Wwf         , Re          , Rb^Uf       , Re^Uf       , Rd          , Rd          , Ce          , Rd          , Re          , Hhd^Fdf     , Rb          , Wwf         , Wwf         , Gd          , Wwf         , Rd          , Wwg         , Rd          , Wwf         , Wwf         , Xu          , Xu          , Ur          , Rb          , Wwf         , Wog         , Xu          , Qxe         , Qxe         , Urb         , Qxe         , Urb         , Qxe         , Qxe         , Qxe         , Qxe         
Qxe         , Qxe         , Qxe         , Qxe         , Urb         , Urb         , Urb         , Qxe         , Qxe         , Xu          , Uu^Vu       , Ur          , Qxu         , Ch          , Ch          , 1 Kh        , Ch          , Wwf         , Xu          , Xu          , Xu          , Rd          , Re          , Ke          , Re          , Rb          , Re          , Hhd         , Re          , Wwf         , Xuc         , Wwf         , Wwf         , Wwf         , Uh          , Qxu         , Ur^Uf       , Wwf         , Ur          , Uu          , Xu          , Xu          , Qxe         , Qxe         , Qxe         , Urb         , Urb         , Urb         , Qxe         , Qxe         , Qxe         , Qxe         
Qxe         , Qxe         , Qxe         , Qxe         , Urb         , Qxe         , Qxe         , Qxe         , Qxe         , Xu          , Xu          , Xu          , Xu          , Qxu         , Qxu         , Qxu         , Qxu         , Qxu         , Xu          , Uh          , Uu          , Ur          , Xu          , Hhd         , Xu          , Xu          , Xu          , Rd          , Xuc         , Xuc         , Qxu         , Xuc         , Xuc         , Uh          , Ur          , Ur          , Ur          , Ur          , Hhd         , Xu          , Qxe         , Qxe         , Urb         , Urb         , Urb         , Qxe         , Urb         , Qxe         , Qxe         , Qxe         , Qxe         , Qxe         
Qxe         , Qxe         , Qxe         , Qxe         , Qxe         , Urb         , Qxe         , Qxe         , Qxe         , Qxe         , Qxe         , Qxe         , Qxe         , Xu          , Xu          , Xu          , Xu          , Xu          , Qxua        , Ai          , Ai          , Ur          , Ur          , Xu          , Ur          , Uh          , Urb         , Xuc         , Urb         , Uu          , Uu^Vud      , Uu          , Urb         , Ur          , Cud         , Ur          , Xu          , Hhd^Fdw     , Xu          , Xu          , Qxe         , Qxe         , Urb         , Qxe         , Urb         , Urb         , Qxe         , Qxe         , Qxe         , Qxe         , Qxe         , Qxe         
Qxe         , Qxe         , Qxe         , Qxe         , Qxe         , Qxe         , Qxe         , Urb         , Urb         , Qxe         , Qxe         , Qxe         , Qxe         , Qxe         , Qxe         , Qxe         , Qxe         , Xu          , Xu          , Qxua        , Qxua        , Ai          , Ur          , Ur          , Ur          , Ur          , Urb         , Urb         , Urb         , Urb         , Urb         , Urb         , Urb         , Uu          , Xuc         , Xu          , Qxe         , Xu          , Qxe         , Qxe         , Qxe         , Urb         , Qxe         , Urb         , Qxe         , Qxe         , Qxe         , Qxe         , Urb         , Qxe         , Qxe         , Qxe         
Qxe         , Qxe         , Qxe         , Qxe         , Urb         , Qxe         , Urb         , Qxe         , Qxe         , Urb         , Qxe         , Qxe         , Qxe         , Qxe         , Qxe         , Qxe         , Qxe         , Qxe         , Qxe         , Xu          , Xu          , Ai          , Xu          , Uu          , Xu          , Xuc         , Xuc         , Wwf         , Kud         , Cud         , Cud         , Urb         , Urb         , Uu          , Xuc         , Qxe         , Qxe         , Qxe         , Urb         , Qxe         , Qxe         , Qxe         , Qxe         , Qxe         , Qxe         , Qxe         , Urb         , Qxe         , Qxe         , Qxe         , Qxe         , Qxe         
Qxe         , Qxe         , Qxe         , Qxe         , Qxe         , Qxe         , Urb         , Qxe         , Qxe         , Qxe         , Qxe         , Qxe         , Urb         , Qxe         , Urb         , Qxe         , Qxe         , Urb         , Qxe         , Qxe         , Qxe         , Xu          , Qxe         , Xu          , Qxe         , Qxe         , Qxe         , Xuc         , Qxu         , Cud         , Md          , Uu^Uf       , Xuc         , Xuc         , Qxe         , Qxe         , Qxe         , Urb         , Qxe         , Urb         , Qxe         , Urb         , Qxe         , Qxe         , Qxe         , Urb         , Qxe         , Urb         , Urb         , Qxe         , Qxe         , Qxe         
Qxe         , Qxe         , Qxe         , Qxe         , Urb         , Qxe         , Qxe         , Qxe         , Urb         , Qxe         , Qxe         , Urb         , Qxe         , Urb         , Qxe         , Urb         , Qxe         , Qxe         , Urb         , Urb         , Qxe         , Qxe         , Qxe         , Qxe         , Urb         , Qxe         , Qxe         , Xuc         , Xuc         , Xuc         , Xuc         , Xuc         , Qxe         , Qxe         , Qxe         , Urb         , Qxe         , Urb         , Qxe         , Urb         , Qxe         , Urb         , Qxe         , Urb         , Qxe         , Urb         , Urb         , Qxe         , Urb         , Qxe         , Qxe         , Qxe         
Qxe         , Qxe         , Qxe         , Qxe         , Qxe         , Qxe         , Qxe         , Qxe         , Qxe         , Qxe         , Qxe         , Qxe         , Urb         , Urb         , Qxe         , Qxe         , Urb         , Qxe         , Urb         , Qxe         , Urb         , Urb         , Qxe         , Qxe         , Qxe         , Qxe         , Qxe         , Qxe         , Qxe         , Qxe         , Qxe         , Qxe         , Qxe         , Qxe         , Qxe         , Urb         , Urb         , Urb         , Qxe         , Qxe         , Qxe         , Qxe         , Qxe         , Qxe         , Qxe         , Qxe         , Qxe         , Urb         , Qxe         , Qxe         , Qxe         , Qxe         
Qxe         , Qxe         , Qxe         , Qxe         , Qxe         , Qxe         , Qxe         , Qxe         , Qxe         , Qxe         , Qxe         , Qxe         , Qxe         , Qxe         , Qxe         , Qxe         , Qxe         , Qxe         , Qxe         , Urb         , Qxe         , Qxe         , Qxe         , Urb         , Qxe         , Urb         , Qxe         , Qxe         , Qxe         , Qxe         , Qxe         , Qxe         , Qxe         , Qxe         , Qxe         , Qxe         , Qxe         , Qxe         , Qxe         , Qxe         , Qxe         , Qxe         , Qxe         , Qxe         , Qxe         , Urb         , Qxe         , Qxe         , Qxe         , Qxe         , Qxe         , Qxe         
Qxe         , Qxe         , Qxe         , Qxe         , Qxe         , Qxe         , Qxe         , Qxe         , Qxe         , Qxe         , Qxe         , Qxe         , Qxe         , Qxe         , Qxe         , Qxe         , Qxe         , Qxe         , Qxe         , Qxe         , Qxe         , Qxe         , Qxe         , Qxe         , Qxe         , Qxe         , Qxe         , Qxe         , Qxe         , Qxe         , Qxe         , Qxe         , Qxe         , Qxe         , Qxe         , Qxe         , Qxe         , Qxe         , Qxe         , Qxe         , Qxe         , Qxe         , Qxe         , Qxe         , Qxe         , Qxe         , Qxe         , Qxe         , Qxe         , Qxe         , Qxe         , Qxe         
