border_size=1
usage=map

Xu          , Xu          , Xu          , Xu          , Xu          , Xu          , Xu          , Xu          , Xu          , Xu          , Xu          , Xu          , Xu          , Xu          , Xu          , Xu          , Xu          , Xu          , Ha^Efm      , Xu          , Xu          , Xu          , Xu          , Xu          , Xu          , Xu          , Xu          , Xu          , Xu          , Xu          , Xu          , Xu          
Xu          , Xu          , Xu          , Xu          , Aa^Edp      , Aa^Efm      , Ur^Br\      , Xu          , Ur^Br\      , Xu          , Ur^Br\      , Xu          , Coa         , Coa         , Coa         , Xu          , Ur^Br/      , Ha^Emf      , Ms^Efm      , Ha^Fpa      , Aa^Uf       , Xu          , Xu          , Xu          , Xu          , Xu          , Xu          , Xu          , Xu          , Xu          , Xu          , Xu          
Xu          , Xu          , Aa^Edp      , Aa^Edp      , Aa^Br|      , Ur^Br/      , Qxu         , Ur^Br/      , Ha          , Ur^Br/      , Ur          , Coa         , Coa         , 2 Koa       , Coa         , Coa         , Ur          , Ur^Br\      , Ur^Br\      , Ha^Edpp     , Ha^Edpp     , Xu          , Ur          , Xu          , Ha^Fmw      , Xu          , Xu          , Xu          , Xu          , Xu          , Xu          , Xu          
Xu          , Ms          , Ms          , Ha^Edp      , Ai^Br|      , Qxu^Bw|r    , Qxu         , Aa^Fpa      , Aa^Bw|      , Aa^Bw/      , Ha          , Ur          , Ur          , Coa         , Ur^Br\      , Ur          , Wwf         , Ha^Fma      , Ha^Efm      , Ur^Br\      , Ur^Br\      , Ur          , Ur          , Aa^Fmw      , Aa^Fmw      , Xu          , Xu          , Xu          , Xu          , Xu          , Xu          , Xu          
Xu          , Ms          , Ha^Fmf      , Ai^Edp      , Wwf^Br\     , Wwf         , Wwf         , Ai^Fpa      , Ai^Bw/      , Aa^Fma      , Wwf         , Wwf         , Wwf         , Wwf         , Wwf         , Wwf^Br|     , Wwf         , Wwt         , Wwf         , Ha^Fpa      , Wwf         , Ur^Br\      , Ur^Br\      , Ur          , Ur          , Ha          , Ms          , Ms^Fds      , Ha^Fpa      , Xu          , Xu          , Xu          
Xu          , Ha^Emf      , Wwt         , Wwf         , Ai^Fdf      , Ur^Br|      , Rp          , Wwf         , Wwf         , Wwf         , Wwf         , Uu          , Uu          , Wwf         , Uu          , Wwf^Br|     , Wwf         , Wwf         , Wwf         , Wwf         , Khw         , Chw         , Wwf         , Rrc^Vhca    , Ur          , Ha^Efm      , Aa^Em       , Ha          , Ur          , Ha          , Ha^Edp      , Xu          
Xu          , Ha          , Wwf         , Wwf         , Ai^Vaa      , Ur^Br/      , Ur          , Uh          , Wwt         , Wwf         , Qxe         , Qxe         , Uu          , Ur^Fdw      , Uu          , Ur^Vhha     , Ur^Br\      , Ur^Br/      , Ur^Br\      , Wwf         , Ha          , Wwf         , Wwf         , Ur^Br|      , Ur          , Ur          , Ur          , Ur          , Ur          , Ur          , Aa          , Xu          
Xu          , Ha^Fdf      , Wwt         , Wwf         , Ur^Br/      , Ur^Br|      , Aa^Uf       , Rb          , Wwf         , Wwf         , Ur          , Qxe^Bs/     , Ur          , Uu^Tf       , Ur^Br/      , Ur^Br|      , Aa^Fpa      , Aa^Fpa      , Aa          , Ur^Br|      , Ur          , Wwf         , Wwt^Br/     , Ai^Br|      , Ai^Fpa      , Ha^Edp      , Ha^Edp      , Ur          , Ur          , Ur          , Aa^Fmf      , Xu          
Xu          , Ai^Em       , Wwf^Br/     , Ur^Br/      , Aa          , Ur^Br\      , Ur^Br\      , Wwf         , Wwf^Fds     , Ur          , Ur          , Qxe         , Ur^Br|      , Ur^Br/      , Ur^Br\      , Ur          , Qxe^Xo      , Ha          , Ur          , Ur^Br\      , Ur^Voa      , Ur^Br/      , Wwf         , Wwf^Br|     , Ur^Br\      , Ha^Fma      , Ur^Br/      , Cea         , Koa         , Ur          , Ha^Fds      , Xu          
Xu          , Ha^Edp      , Wwf^Br|     , Wwf         , Ai^Uf       , Ha          , Wwf^Br|     , Wwf         , Ur          , Ur          , Cha         , Kha         , Cha         , Ur          , Ur^Ft       , Qxu^Bs\     , Aa^Vha      , Qxu^Bs/     , Ur          , Ur          , Ur^Uf       , Ur          , Wwf         , Wwf         , Wwt         , Wwf^Br|     , Wwt         , Cea         , Ur          , Ur          , Aa^Edp      , Xu          
Xu          , Uue^Br/     , Wwf         , Wwf         , Ai^Fmw      , Wwf         , Wwf^Br\     , Wwf         , Ha          , Ur          , Uu^Br/      , Cha         , Ur          , Ur          , Ur          , Qxe         , Rb          , Qxe         , Ur^Dr       , Ur          , Ur          , Ur          , Ur          , Wwf         , Wwf         , Wwf^Vla     , Wwf         , Ur          , Ur          , Aa^Edp      , Aa^Fmf      , Xu          
Xu          , Uue^Br|     , Wwf         , Wwf         , Chw         , Wwf         , Ur^Br/      , Uu^Vea      , Ur^Br\      , Ur^Br/      , Ur          , Ur          , Ur          , Uu^Vu       , Rb          , Rb          , Aa^Fdf      , Rb          , Rb          , Ur          , Ur          , Xuce        , Xuce        , Wwf^Fdf     , Ur          , Wwf         , Wwf         , Wwf         , Wwf         , Ur          , Aa^Fmf      , Xu          
Xu          , Uue^Vud     , Wwf^Br\     , Wwt         , Wwf^Br/     , Ur^Br/      , Ur          , Ur          , Qxu^Bs\     , Ur          , Ha          , Ur          , Rb          , Rb          , Rb          , Rb          , Rb          , Rb          , Rb          , Rb          , Ur^Fp       , Qxe         , Xuce        , Ur          , Ur          , Ur          , Wwf         , Wwt^Ewl     , Wwf         , Ai^Fpa      , Ai          , Xu          
Xu          , Ai^Fds      , Wwf         , Wwf^Br\     , Wwf         , Ur          , Uu^Fp       , Xu          , Qxe         , Ur          , Ur          , Cha         , Rb          , Rb          , Rb          , Rb          , Ha          , Rb          , Rb          , Rb          , Uu          , Qxe         , Xuce        , Uh^Fmf      , Uue         , Ur          , Wwf         , Wwf         , Wwf         , Ha^Fds      , Ha          , Xu          
Xu          , Ha          , Wwf         , Wwt         , Wwf^Fp      , Ur          , Ur^Fp       , Xu          , Qxe         , Ur          , Ha          , Ur          , Rb          , Rb          , Rb^Efm      , Ha^Uf       , Ms^Xm       , Ha^Fds      , Rb          , Rb          , Uh          , Qxe         , Qxe         , Xuce        , Ur^Fdf      , Ur          , Ur^Uf       , Wwt         , Wwf         , Ha          , Ai^Efm      , Xu          
Ai          , Ha^Fds      , Wwf         , Wwf         , Ur          , Ur          , Ur          , Xu          , Xu          , Qxe         , Aa^Uf       , Cha         , Rb^Fp       , Rb          , Rb          , Ha^Fds      , Ha          , Ha^Uf       , Rb          , Rb          , Ur          , Uh^Fp       , Qxe         , Xuce        , Uh          , Ur          , Ur          , Wwf         , Wwr         , Wwf         , Wwf^Fds     , Xu          
Wwf         , Wwf         , Wwf         , Wwt         , Ur          , Ur          , Ur          , Hh          , Xu          , Qxe         , Qxe         , Ur          , Uue^Fp      , Rb          , Rb          , Rb          , Rb          , Rb          , Rb          , Rb          , Cha         , Ur          , Ur          , Xuce        , Xuce        , Ur          , Ur          , Wwf         , Wwf^Br\     , Wwf         , Aa^Fdf      , Xu          
Xu          , Wwf         , Wwf         , Wwf         , Wwr         , Ur^Uf       , Ur          , Ur^Fdf      , Uh          , Xu          , Qxe         , Uh          , Rb          , Rb          , Rb          , Aa^Fds      , Rb          , Rb          , Rb          , Rb          , Ur          , Ha          , Ur          , Ur          , Ur          , Uh^Fdf      , Ur^Br/      , Wwf^Br/     , Wwt         , Wwf^Br\     , Uue^Vud     , Xu          
Xu          , Xu          , Ha^Emf      , Wwf         , Wwf         , Wwf         , Wwf         , Ur          , Ur          , Xu          , Xu          , Ur          , Ur          , Rb          , Qxe         , Rb          , Qxe         , Rb          , Ur          , Uu^Vu       , Ur          , Ur          , Ur^Br/      , Hh^Br\      , Ai^Voa      , Ur^Br/      , Wwf         , Chw         , Wwf         , Wwf         , Uue^Br|     , Xu          
Xu          , Xu          , Ha^Edp      , Ur          , Ur          , Wwt         , Wwf^Vla     , Wwf         , Wwf         , Ur^Fmf      , Ur          , Ur          , Ur          , Ur          , Qxu^Bs/     , Aa^Vha      , Qxu^Bs\     , Ur          , Ur^Ft       , Ur          , Ur^Fmw      , Ur^Br/      , Ur          , Uu^Tf       , Ai          , Wwf^Br\     , Wwf         , Aa^Fds      , Wwf         , Wwf         , Uue^Br/     , Xu          
Xu          , Ha^Fpa      , Ur          , Ur          , Cea         , Wwf^Br/     , Wwf         , Wwf^Br\     , Wwf         , Wwf         , Ur^Br/      , Ur^Br\      , Ur^Vhha     , Ur^Br/      , Ur^Br\      , Qxe^Xo      , Ur          , Ur          , Ur          , Ur          , Cha         , Ur^Br|      , Ur          , Ur          , Wwf         , Wwf^Br|     , Ha          , Ai^Uf       , Wwf         , Wwf^Br|     , Hhd^Fmf     , Xu          
Xu          , Aa^Em       , Ur          , Koa         , Cea         , Ur          , Aa^Fmf      , Ai^Br|      , Wwf^Br\     , Wwf^Br/     , Ur          , Ur^Uf       , Ur          , Ha          , Aa^Fma      , Ur^Br|      , Ur          , Ur          , Aa^Uf       , Cha         , Kha         , Cha         , Ur^Br\      , Ur          , Wwf         , Wwf^Br\     , Ur^Br|      , Ai^Fds      , Wwf^Br/     , Wwf^Br/     , Ai          , Xu          
Xu          , Aa^Fdf      , Ur          , Ur          , Ur          , Ha          , Ur^Emf      , Ai^Fmf      , Wwf^Br|     , Wwt         , Wwf         , Ur          , Ur          , Aa^Fma      , Ur          , Ur^Br|      , Ur          , Ha          , Ur^Br/      , Ur^Br/      , Qxe         , Ur          , Ur          , Wwf^Br\     , Wwf^Br\     , Ai          , Ur^Br/      , Ur^Br/      , Wwf         , Wwf         , Ai^Fmf      , Xu          
Xu          , Xu          , Ha          , Ur          , Ur          , Ur^Esd      , Ur^Es       , Ur          , Ur^Br|      , Wwf         , Wwf         , Ha          , Wwf         , Ur          , Ur          , Ur^Br\      , Ur^Vca      , Ur^Br/      , Uu^Fdw      , Uu          , Qxu^Bs/     , Ur          , Wwf         , Wwf         , Ai^Uf       , Ur^Br|      , Aa^Fdf      , Ai^Vaa      , Wwf         , Wwf         , Ai^Edpp     , Xu          
Xu          , Xu          , Ha^Emf      , Ur^Efm      , Ur^Efm      , Ur          , Ur          , Ur          , Rrc^Vhca    , Wwf         , Khw         , Wwt         , Wwf         , Wwf         , Ur          , Ur          , Ur^Br|      , Uu^Fdw      , Ur          , Uu          , Qxe         , Qxe         , Wwf         , Wwf         , Wwf^Br/     , Ur^Br|      , Ur          , Ai^Emf      , Wwf         , Wwf         , Ai^Edpp     , Xu          
Xu          , Xu          , Xu          , Ha^Fpa      , Ha^Efm      , Ms^Efm      , Ha          , Ur          , Ur^Br|      , Wwf         , Chw         , Wwf         , Ww          , Wwf         , Ww          , Wwf         , Wwf         , Wwf^Br\     , Wwf^Br|     , Wwf         , Wwf         , Wwf         , Ha^Uf       , Uu          , Uu^Br|      , Wwf         , Wwf         , Ur          , Wwf         , Ai^Edpp     , Ai^Fmf      , Xu          
Xu          , Xu          , Xu          , Xu          , Xu          , Xu          , Xu          , Aa^Fma      , Aa^Fma      , Ur^Br\      , Ur^Br\      , Ur^Br/      , Ur^Br\      , Wwf         , Wwt         , Wwf         , Wwf         , Wwf         , Coa         , Wwf         , Ur          , Ha^Fds      , Ha          , Ha^Uf       , Ur^Br|      , Qxe         , Qxe^Bw|     , Wwf         , Ur          , Ai^Fds      , Aa^Edpp     , Xu          
Xu          , Xu          , Xu          , Xu          , Xu          , Xu          , Xu          , Ha^Fds      , Xu          , Ur          , Xu          , Ur          , Ha^Fpa      , Ur^Br\      , Ur^Br\      , Ww          , Coa         , Coa         , 1 Koa       , Coa         , Coa         , Ur^Br/      , Ur^Br\      , Ur^Br/      , Ur          , Qxe         , Ur          , Ur          , Ha          , Aa^Edpp     , Ha          , Xu          
Xu          , Xu          , Xu          , Xu          , Xu          , Xu          , Xu          , Xu          , Xu          , Xu          , Xu          , Ha^Fpa      , Xu          , Ha^Edp      , Aa^Emf      , Ur^Br/      , Xu          , Coa         , Coa         , Coa         , Xu          , Ur          , Ha^Fmw      , Ha          , Aa^Efm      , Ur          , Ha^Uf       , Ha^Fp       , Ms          , Ms^Fms      , Xu          , Xu          
Xu          , Xu          , Xu          , Xu          , Xu          , Xu          , Xu          , Xu          , Xu          , Xu          , Xu          , Xu          , Xu          , Xu          , Xu          , Xu          , Xu          , Xu          , Xu          , Xu          , Xu          , Xu          , Xu          , Xu          , Xu          , Xu          , Xu          , Xu          , Xu          , Xu          , Xu          , Xu          
