Xuc, Xuc, Xuc, Xuc, Xuc, Xuc, Xuc, Xuc, Xuc, Xuc, Xuc, Xuc, Ur, Ur, Gs, Gg, Uh, Ur, Ur, Ur, Ur, Ur, Ur, Ur, Ur, Ur, Uue, Uue, Uue, Uue, Uue, Gd, Gd, Mm^Xm, Mm^Xm, Hhd^Fdw, Dd^Dr, Dd^Br|, Dd, Dd, Dd, Dd, Dd^Br|, Gs, Gg^Br/, Gg^Br/
Xuc, Xuc, Xuc, Xuc, Xuc, Xuc, Xuc, Xuc, Xuc, Ur, Ur, Ur, Ur, Ch, Rr, Rr, Rr, Rr, Uu^Tf, Ur, Ur, Ur, Ur, Ur, Uu^Vu, Uu^Tf, Gd, Gd, Gd, Gd, Gd, Gd, Gd, Md^Xm, Mv, Hh, Hh^Fp, Dd^Br|, Hd, Dd^Dr, Rd^Br\, Dd^Vda, Dd^Br/, Uu^Tf, Gg^Br|, Gg
Xuc, Xuc, Xuc, Xuc, Xuc, Xuc, Xuc, Xuc, Ur, Ur, Ur, Ur, Ur, Ur, Gg, Rr, Gg, Rr, Uu, Ur, Uu, Ur, Uu, Ur, Uu, Gg, Gll, Gg, Gd, Hhd, Gd, Gd, Gd, Md^Xm, Md, Md, Hh^Fp, Rd^Br\, Dd^Br\, Dd^Br/, Hd, Dd^Br/, Ww^Ewf, Ww^Ewf, Gg^Br|, Gg
Xuc, Xuc, Xuc, Xuc, Xuc, Xuc, Xuc, Xuc, Ur, Ur, Qxu, Qxu, Gg, Gs, Qlf, Ch, Gg, Gg, Gg, Uu, Ur, Gg, Gg, Uu, Gg, Gg, Hhd, Md, Gll, Hh^Fds, Gd, Gd, Gg, Hh, Md, Md^Xm, Hh^Fms, Rd, Hh^Fp, Dd^Br\, Dd^Br\, Dd^Br/, Dd^Br\, Uu^Tf, Gg^Br|, Gg
Xuc, Xuc, Xuc, Xuc, Xuc, Xuc, Ur, Ur, Qxu, Qxu, Qxua^Xo, Qxu, Qxu, Qxu, Gg, Gg, Gs, Ur, Gg, Gd^Fdf, Gg, Gg, Gg, Gg, Gg, Uu^Tf, Gg, Gll, Gg, Gg, Gg, Hhd, Mm, Gg, Hh, Gd, Md, Md^Xm, Md^Xm, Dd, Md, Hd, Ww^Ewf, Gs^Br/, Gs, Gg
Xuc, Xuc, Xuc, Xuc, Xuc, Xuc, Ur, Ur, Ch, Qxu, Qxu, Qxu, Qxu^Bs/, Qxu^Bs/, Gg, Gg, Gs, Gd^Fdf, Ur, Gg, Gg, Uu^Tf, Gg, Dd, Dd, Gg, Md, Gll, Gg, Gg, Kh, Gg, Gll, Gll, Hh^Fds, Gll, Hh, Hh, Md, Md, Md, Md, Md, Ww^Ewf, Gs, Gs
Xuc, Xuc, Xuc, Xuc, Xuc, Ch, Ur, Ur, Qxu, Qxu, Qxu^Bs/, Qxu^Bs/, Qxu, Gg^Dr, Uu^Tf, Qxu, Gg, Gg, Gg, Gg, Gg, Gg, Gg, Gd^Vo, Gg, Gg, Hh^Fds, Gll, Gg, Gg, Ch, Gg, Gll, Gll, Gll, Gll, Gll, Hh, Hh, Md^Xm, Md^Xm, Mv, Md, Ww^Ewf, Gd^Edp, Gs^Edp
Uu^Tf, Uu^Dr, Uu^Dr, Xuc, Ur, Uu, Ur, Ur^Dr, Qxu^Bs/, Qxu^Bs/, Qxu, Qxu, Qxu, Uu^Tf, Uu^Tf, Gg, Qxu, Gg, Gg, Gg, Uh, Gg, Gg, Gg, Gg, Hh^Fds, Gll, Gg, Gg, Ch, Gg, Gg, Gll, Gg, 2 Ke, Gll, Gll, Gll, Gll, Mm, Hhd^Vhhr, Md^Xm, Md, Ww^Ewf, Gd, Gd
Uu^Tf, Uu, Uu^Tf, Uu, Uu^Tf, Uu, Ur, Ur, Gg, Qxu, Qxu, Qxua^Xo, Qxu, Qxu, Gg, Gg, Ce, Ce, Gg, Gg, Gg, Gg, Gs, Gg, Gg, Gg, Gll^Fp, Gll, Gg, Gg, Gll, Gll, Gg, Ce, Gg, Ce, Gg, Gg, Gll, Mm, Mm, Hhd^Fdw, Hhd^Fdw, Md, Md, Md
Uu^Tf, Uu^Tf, Uu, Uu, Uu^Dr, Uu, Ur, Ur, Gg, Uu^Tf, Uu^Tf, Qxu, Qxu, Uu^Tf, Ce, Co, Gg, Gg, Gg, Gg, Gg, Dd, Hh^Fp, Gg, Gg, Gg, Gg, Gll, Gg, Uu^Tf, Gll, Gll, Gg, Ce, Gg, Gg, Uu^Tf, Gll, Gll, Gll, Gg, Hh^Fds, Md, Md, Gd^Edp, Gd
Ur, Uu, Uu, Uu, Ur, Ur, Ur, Ur, Gg, Gg^Dr, Gg, Uu^Tf, Uu^Tf, Ce, Gg, Qlf, Rp, Gg, Gg^Dr, Qxu, Gg, Dd^Vda, Gg, Gg, Hh^Fp, Mm, Gg, Gg, Gg, Gg, Hh^Fds, Gll, Gll, Gg, Gll, Gg, Gll, Gll, Gs^Ft, Gg, Hh^Fds, Md, Hhd^Fdw, Gd^Edp, Hhd, Gd
Ur, Uu^Dr, Uu, Uu^Tf, Ur, Ur, Ur, Ur, Ur, Uh, Uu, Uu^Tf, Uu, Gg, Gg, Gg, Gg, Rp, Rp^Dr, Wo, Rp, Gg, Rb, Gg, Rp, Rb, Rb, Gg, Uu^Tf, Gg, Md, Gg, Gg, Gd^Vo, Gll, Gll, Gg, Gg, Gg, Hh^Fds, Gg, Md, Hhd^Fdw, Hhd, Gg, Gg
Uu^Tf, Ur, Gg, Ur, Ur, Ur, Uu^Tf, Ur, Gg, Ur, Ur, Gg, Ur, Gg, Rp, Qlf^Br\, Gg, Gg^Dr, Gg^Dr, Wo, Wo, Wo, Wo^Bw|r, Wwrg, Wo, Wwg, Wwg, Wwrg, Wwf, Rb, Rb, Gll, Gll, Dd, Gg, Gg, Gg, Ke, Ur, Hh^Fds, Md, Md, Hhd^Fdw, Hhd^Fdw, Md, Gg
Gg, Ur, Ur, Ur, Ur, Ur, Ur, Ur, Uh, Gg, Gg^Ve, Ur, Gg, Rp, Rp, Rp, Gg, Gg^Dr, Wo, Wo, Rp, Gg, Gg, Rb, Rb, Gg, Hh^Fds, Ww^Vm, Rb, Wwf, Gg, Rb, Gg, Gll, Gg, Uu^Tf, Gg, Ce, Gg, Hh^Fds, Hh^Fds, Md, Md, Md, Md, Md
Gg, Gg, Uh, Uh, Gg, Gg, Gg, Gg, Gg, Ur, Gg, Gg, Dd, Uu^Tf, Gg, Rp, Wo, Wo, Rb, Wo, Rb, Rp, Dd, Rb, Dd, Rp, Wwf, Wwf, Rb, Rb, Kh, Rb, Gg, Gg, Gg, Gg, Gg, Ce, Gg, Gg, Hh^Fds, Md, Hhd, Hhd, Rrc, Rrc
Ms, Gg, Gg, Gg, Gg, Gg, Gg, Gs^Ft, Gg, Ur, Gg, Gg, Gg, Gg, Wo, Wo, Hh^Fp, Rp, Gg, Wo, Wwrg, Rp, Rb, Rb, Hh^Fds, Wwf, Gs, Gs, Rb, Ch, Gs^Fds, Wwf, Uu^Tf, Uu^Tf, Gg, Gg, Gg, Gg, Gg, Gg, Uu^Tf, Hh^Fds, Ss, Rrc, Dd^Edp, Dd
Ms, Gg, Uu^Tf, Gg, Gg, Mm, Gs^Ft, Gg, Gg, Uu^Tf, Gg, Gg, Gs^Ft, Gg, Gg, Hh^Fp, Mm, Rp, Rp, Wwg, Chw, Rb, Gg, Gg, Rb, Wwf, Gs, Hh, Dd, Gg, Rb, Wwf, Gg, Gs^Ft, Gll, Gll, Gg, Md, Gs^Ft, Gll, Gg, Md^Xm, Ss, Rrc, Dd, Dd^Edp
Ms, Gg, Gg, Gg^Fet, Gg, Gg, Gg, Gg, Gg, Gg, Gg, Gg, Rp, Gg, Gg, Rb, Gg, Gg, Rp, Khr, Wwf, Gg, Gs^Fds, Rb, Rp, Wwf, Dd^Dr, Rb, Rb, Gg, Wog, Wog, Dd, Ce, Gll, Gg, Gg, Gll, Hh, Gll, Md^Xm, Md^Xm, Ss, Rrc, Rrc, Dd^Edp
Ms, Gg, Gg, Gg, Gg, Uu^Tf, Gg, Hh, Gg, Gg, Cdr, Gg, Rp, Gg, Hh^Fp, Rb, Rb, Gg, Hh^Fds, Uu^Tf, Gg, Wwf, Wwf, Rp, Rp, Wwf, Rp, Dd, Rb, Wog, Wog, Wog, Gs, Gll, Gd^Vo, Gg, Uu^Tf, Gg, Rrc, Gg, Md^Xm, Ss, Sm, Sm, Rrc, Gd
Ms, Ms, Gg, Gd^Vo, Gg, Gg, Md, Gg, Gg, Gg, Cdr, Gg, Gd^Fdf, Gg, Rrc, Md, Rb, Gg, Rp, Gg, Rb, Rb, Rb, Ww^Vm, Wwf, Wwg, Gg, Rb, Wog, Wog^Bsb\, Rrc, Gg^Dr, Gs, Gg, Gg, Gg, Rrc, Rrc, Gs, Rrc, Rrc, Ss, Sm, Gll, Rrc, Gd
Ms, Ms, Ms, Gg, Gg, Gg, Gg, Gg, Gg, Kh, Rrc, Gg, Rrc, Rrc, Gg, Rrc, Rrc, Rb, Rb, Gg, Gg, Rb, Gg, Rb, Rb, Wwg, Wwg, Wwrg, Gg, Gs, Gg, Rrc, Rrc, Rrc, Rrc, Rrc, Dd, Gs, Gs, Gs, Dd^Do, Rrc, Rrc, Gll, Rrc, Gd
Ms, Ms, Ha^Fpa, Gg, Gg, Uu^Tf, Gg, Gg, Gg, Gg, Gg, Rrc, Gg, Gg, Cd, Cd, Gg, Rrc, Rrc, Gg, Gg, Gg, Gll^Fp, Uu^Tf, Gg, Rb, Wwf, Hh^Fds, Gg, Gs, Gs, Gs, Gg, Gg, Dd, Gg, Dd, Dd, Gs, Gs, Gd, Dd, Gd, Rrc, Gs, Gd
Ms, Ms, Ms, Ms, Gg, Gg, Md, Hh, Gg, Gg, Gg, Rrc, Cdr, 1 Kh, Gg, Gg, Gg, Gg, Kh, Cv, Cv, Gg, Gg, Md, Gg, Gs^Ft, Wwf, Rb, Ur, Uu^Tf, Gg, Gs, Hd, Gg, Rd, Dd^Edp, Dd^Edpp, Rd, Rd, Rd, Rd, Dd, Dd, Dd, Rd, Gd
Ha^Fpa, Ms, Ms, Ms, Gg, Gg, Gg, Gg, Md, Gg, Rrc, Rrc, Gg, Gg, Gg, Gg, Gg, Gg, Gg, Gg, Gg, Cdr, Rd, Gg, Gg, Gg, Wwf, Gg, Gd^Vo, Gg, Gg, Gg, Gs^Ft, Rd, Gd, Dd, Dd, Dd^Edp, Rd, Dd, Dd^Do, Dd, Dd^Edpp, Dd^Edpp, Rd, Gd
Ha^Fpa, Ms, Ms, Ms, Gg, Gg, Gg, Gg, Rrc, Rrc, Gll^Fp, Gll^Fp, Gg, Gg, Gg, Gg, Gs, Gs, Gs, Gg, Gg, Gg, Gg, Rd, Rd, Rd, Wwf, Rd, Rd, Gg, Ce, Rd, Rd, Rd, Dd^Do, Gd, Rd, Gd, Rd, Dd, Rd, Dd, Rd, Rd, Dd, Gd
Ms, Ms, Aa, Gg, Aa, Aa, Aa, Gg, Rrc, Gg, Gg, Gg, Gg, Hh^Fp, Gg, Gg, Gs, Uu^Tf, Gs, Hh^Fp, Gg, Gg, Hh^Fds, Gd^Vo, Gg, Gs^Fds, Wwf, Dd, Gg, Rd, Md, Gg^Fet, Rd, Rd, Dd^Edpp, Rd, Dd, Rd, Rd, Rd, Dd, Rd, Dd^Edpp, Rd, Dd^Esd, Gd
Aa, Aa, Ai, Aa, Aa, Aa, Aa, Aa, Rrc, Aa, Ai, Aa, Aa, Gg, Aa, Gg, Gs, Gs, Gs, Gs, Gg, Gg, Gg, Gg, Gg, Gg, Wwf, Wwf, Wwf, Rd, Gg, Gg, Rd, Dd, Dd, Dd, Dd^Edpp, Dd^Edpp, Rd, Dd^Do, Dd^Esd, Dd^Esd, Dd^Esd, Dd^Esd, _off^_usr, _off^_usr
Aa, Aa, Aa, Ai, Ai, Aa, Ai, Aa, Rrc, Aa, Aa, Aa^Vaa, Aa, Aa, Aa, Aa, Aa, Gs, Gs, Gs, Gs, Gg, Gs, Gs^Fds, Wwf, Wwf, Gd, Gg, Gd, Wwg, Wwg, Wwg, Ss, Ss, Ss, Ss, Dd^Edp, Dd, Rd, Dd^Edp, Dd^Edpp, Dd^Esd, _off^_usr, _off^_usr, _off^_usr, _off^_usr
Aa, Aa, Aa, Ai, Ai, Ai, Aa, Aa, Rrc, Ai, Aa, Aa, Aa, Ai, Ai, Aa, Aa, Aa, Gs, Hh^Fp, Gg, Gs, Wwf, Wwf, Gd, Gs, Gd, Gd, Gd, Gg, Gg, Gg, Gg, Gg, Ss, Ss, Dd, Rd, Dd, Dd, _off^_usr, _off^_usr, _off^_usr, _off^_usr, _off^_usr, _off^_usr
Ms^Xm, Aa, Ms, Aa^Dr, Aa^Dr, Aa^Dr, Rrc, Rrc, Aa, Aa, Aa, Ai, Aa, Ai, Ai, Aa, Aa, Aa, Gs, Gs, Wwf, Wwf, Gg, Dd, Gd, Dd^Vda, Gg, Aa^Fda, Gd, Gg, Gg, Gg, Ha^Fma, Gg, Ss, Gd, Gd, Rd, _off^_usr, _off^_usr, _off^_usr, _off^_usr, _off^_usr, _off^_usr, _off^_usr, _off^_usr
Ms^Xm, Ms, Ms^Xm, Ms, Ha^Fma, Rrc, Aa^Dr, Aa, Ha, Aa, Aa, Aa, Aa, Aa, Aa, Ai, Aa, Aa, Wwf, Wwf, Gg, Gg, Gs, Dd, Gd, Gg, Ha^Fpa, Dd, Gd, Ha^Fma, Aa^Fda, Gg, Ha^Fpa, Gd, Gd, Gd, _off^_usr, _off^_usr, _off^_usr, _off^_usr, _off^_usr, _off^_usr, _off^_usr, _off^_usr, _off^_usr, _off^_usr
Ms^Xm, Ms^Xm, Ha^Fma, Ms, Rra, Ms, Ms, Ha^Fpa, Ha, Aa, Aa, Ai, Ai, Aa, Aa, Ai, Aa, Aa, Aa, Aa, Gg, Gg, Gg, Gg, Ha^Fpa, Gs, Gg, Gd, Ha, Gg, Aa^Fda, Gg, Aa^Fda, Aa^Fpa, _off^_usr, _off^_usr, _off^_usr, _off^_usr, _off^_usr, _off^_usr, _off^_usr, _off^_usr, _off^_usr, _off^_usr, _off^_usr, _off^_usr
Ms, Aa^Fpa, Ms, Ms, Rrc, Ms, Ha^Fma, Ms, Ms, Ha^Fpa, Aa, Aa, Aa, Ai, Aa, Ai, Ai, Aa, Wot, Aa^Fpa, Gg, Ha^Fpa, Gs, Gg, Ha, Aa^Fda, Gg, Gd, Gd, Gd, Ha, Gg, _off^_usr, _off^_usr, _off^_usr, _off^_usr, _off^_usr, _off^_usr, _off^_usr, _off^_usr, _off^_usr, _off^_usr, _off^_usr, _off^_usr, _off^_usr, _off^_usr
Ms, Aa^Vla, Aa^Br\, Ha^Fpa, Ms, Ms, Ms, Aa^Fpa, Ha, Ms, Ms, Ha, Aa, Aa, Aa, Aa, Aa, Ai, Wot, Wot, Wot, Wot, Wot, Gs, Wot, Ha, Gs, Ha, Gs, Ha, _off^_usr, _off^_usr, _off^_usr, _off^_usr, _off^_usr, _off^_usr, _off^_usr, _off^_usr, _off^_usr, _off^_usr, _off^_usr, _off^_usr, _off^_usr, _off^_usr, _off^_usr, _off^_usr
Ms, Aa^Fpa, Aa^Br|, Aa^Fpa, Aa, Ms, Cha, Kha, Aa, Ha, Ms, Ha^Fpa, Aa, Ha^Fpa, Aa, Aa, Aa, Aa, Gg, Gg, Gg, Wot, Gg, Wot, Gg, Wot, Wot, Gg, _off^_usr, _off^_usr, _off^_usr, _off^_usr, _off^_usr, _off^_usr, _off^_usr, _off^_usr, _off^_usr, _off^_usr, _off^_usr, _off^_usr, _off^_usr, _off^_usr, _off^_usr, _off^_usr, _off^_usr, _off^_usr
