border_size=1
usage=map

Wo          , Wo          , Ww          , Ww          , Gs^Fp       , Gs          , Gs^Fms      , Gs^Fds      , Gg          , Gg          , Gs          , Hh^Fds      , Hh^Fp       , Hh          , Hh          , Hh^Fms      , Gs          , Gs          , Gs          , Gs^Fds      , Hh^Fms      , Ce          , Ce          , Ce          , Ce          , Ce          
Ww          , Wo          , Ww          , Wwf         , Wwf         , Gs          , Gs          , Gs^Fp       , Gs          , Gg          , Gg          , Gs^Fms      , Re^Vhc      , Gs          , Hh          , Mm          , Gg          , Gs          , Gg          , Gs^Fp       , Hh          , Ce          , Ce          , Ce          , Ce          , Ce          
Gs^Fms      , Ww          , Wwf         , Wwf         , Wwf         , Wwf         , Ww          , Gs          , Gll^Uf      , Gs          , Gg          , Gg          , Gs          , Gs          , Gs          , Gs^Fms      , Gg          , Gs          , Ce^Vct      , Gs          , Gg          , Gs          , Gs          , 2 Ke        , Ce          , Ce          
Gs          , Wwf         , Wwf         , Wwf         , Ww          , Ww          , Wo          , Ww          , Wwf         , Gs          , Gs          , Gs          , Ce          , Ket         , Gs          , Gs          , Gg          , Gg          , Gs          , Gg          , Gg          , Gs          , Gs          , Gs          , Gg          , Ce          
Gg          , Gs          , Wwf         , Hh^Fds      , Ww          , Wo          , Wo          , Ww          , Wwf         , Gs          , Hh^Fms      , Wwf         , Wwf         , Ce          , Gs          , Gll^Uf      , Gg          , Gg          , Gs          , Gs          , Gg          , Gs^Fds      , Gs          , Gs          , Gll^Uf      , Gs^Fms      
Hh          , Gs          , Gs          , Wwf         , Gs          , Ww          , Wwf         , Wwf         , Wwf         , Wwf         , Ww          , Ww          , Wwf         , Gs          , Gs^Fds      , Gg          , Gs          , Gg          , Hh^Fp       , Gs          , Gs          , Gg          , Gg          , Gg          , Gg          , Hh          
Gs          , Hh          , Gs          , Gs          , Gg          , Hh^Fp       , Gs          , Wwf         , Gs^Fds      , Ww          , Wo          , Ww          , Wwf         , Gs          , Gs          , Gs          , Ce^Vct      , Gs          , Gg          , Gg          , Gs          , Gg          , Gg          , Gs          , Gg          , Gs          
Gg          , Gg          , Gg          , Gll^Uf      , Gg          , Gg          , Gs          , Wwf         , Ww          , Wo          , Wo          , Ww          , Ww          , Wwf         , Wo^Bsb|     , Wwf         , Wwf         , Gs          , Gg          , Gg          , Hh          , Gs          , Gg          , Ce^Vct      , Gg          , Gs          
Gs          , Gs          , Gs^Fp       , Gg          , Gg          , Re^Vhc      , Gs          , Gs          , Ww          , Wo          , Ww          , Ww          , Wwf         , Wwf         , Gs          , Wwf         , Wo^Bsb/     , Gs          , Gs          , Gs^Fms      , Gg          , Gg          , Gg          , Gs          , Gs          , Gs          
Hh          , Hh^Fds      , Mm          , Gg          , Gg          , Gg          , Ket         , Ce          , Wwf         , Ww          , Wwf         , Wwf         , Wwf         , Wwf         , Hh^Fds      , Gs          , Wwf         , Wwf         , Ce          , Gs          , Gs          , Gg          , Gs^Fp       , Gg          , Hh          , Gg          
Gg          , Hh          , Gs          , Gs^Fms      , Gs          , Gs          , Gs          , Ce          , Wwf         , Wwf         , Gs          , Hh^Fds      , Wwf         , Wwf         , Wwf         , Wwf         , Ww          , Wwf         , Ce          , Ket         , Gs          , Gg          , Gg          , Mm          , Hh^Fds      , Hh          
Gg          , Gg          , Gg          , Gs          , Gg          , Gs          , Gs^Fds      , Gs          , Gs          , Wo^Bsb/     , Wwf         , Gs          , Wwf         , Wwf         , Ww          , Ww          , Wo          , Ww          , Gs          , Gs          , Re^Vhc      , Gg          , Gg          , Gs^Fms      , Gs          , Gs          
Gs          , Gg          , Ce^Vct      , Gg          , Gg          , Hh          , Gg          , Gg          , Gs          , Wwf         , Wwf         , Wo^Bsb|     , Wwf         , Ww          , Ww          , Wo          , Wo          , Ww          , Wwf         , Gs          , Gs          , Gg          , Gll^Uf      , Gg          , Gs          , Gs          
Gs          , Gs          , Gg          , Gg          , Gg          , Gg          , Gg          , Gg          , Gg          , Ce^Vct      , Gs          , Gs          , Gs          , Wwf         , Ww          , Wo          , Ww          , Gs^Fms      , Wwf         , Gs          , Hh^Fp       , Gs          , Gs          , Gg          , Hh          , Gs          
Hh          , Gs          , Gs          , Gg          , Gg          , Gg          , Gg          , Hh^Fms      , Gg          , Gs          , Gg          , Gs^Fp       , Gs          , Wwf         , Ww          , Ww          , Wwf         , Wwf         , Wwf         , Wwf         , Ww          , Gs          , Wwf         , Gs          , Gs          , Hh          
Gs^Fp       , Gll^Uf      , Gs          , Gs          , Gs^Fms      , Gg          , Gs          , Gs          , Gs          , Gs          , Gll^Uf      , Gg          , Ce          , Wwf         , Wwf         , Hh^Fms      , Gs          , Wwf         , Ww          , Wo          , Wo          , Ww          , Hh^Fms      , Wwf         , Gs          , Gs          
Ce          , Gs          , Gs          , Gg          , Gs          , Gs          , Gs          , Gg          , Gg          , Gg          , Gg          , Gg          , Ket         , Ce          , Gs          , Gs          , Gs          , Wwf         , Ww          , Wo          , Ww          , Ww          , Wwf         , Wwf         , Wwf         , Gs          
Ce          , Ce          , 1 Ke        , Gg          , Gg          , Gs          , Gg          , Ce^Vct      , Gg          , Gg          , Gs^Fds      , Gg          , Gs          , Gs          , Gg          , Gg          , Gg          , Gll^Uf      , Gs          , Ww          , Wwf         , Wwf         , Wwf         , Wwf         , Ww          , Gs^Fds      
Ce          , Ce          , Ce          , Ce          , Ce          , Hh          , Gs^Fp       , Gg          , Gg          , Gs          , Mm          , Hh          , Gs          , Re^Vhc      , Gs^Fms      , Gg          , Gs          , Gg          , Gs^Fms      , Gs          , Gs          , Wwf         , Wwf         , Ww          , Wo          , Ww          
Ce          , Ce          , Ce          , Ce          , Ce          , Hh^Fms      , Gs^Fds      , Gs          , Gs          , Gs          , Hh^Fp       , Hh          , Hh          , Hh^Fms      , Hh^Fp       , Gg          , Gg          , Gg          , Gs^Fds      , Gs^Fp       , Gs          , Gs          , Gs^Fds      , Ww          , Wo          , Wo          
