Mm, Mm, Ai, Mm, Ai, Mm, Mm, Mm, Aa^Fpa, Wwf, Aa, Aa, Aa, Aa, Aa, Aa^Fpa, Aa^Fpa, Mm, Mm, Mm^Xm, Mm^Xm, Mm^Xm, Mm^Xm, Mm^Xm, Ai, Mm^Xm, Ai, Mm^Xm
Mm, Ai, Mm, Ai, Aa, Ai, Aa, Mm, Aa^Fpa, Wwf, Gg^Efm, Aa, Gg^Efm, Gg^Efm, Gg^Efm, Aa^Vha, Aa, Aa^Fpa, Ha^Fpa, Mm, Mm, Mm^Xm, Mm^Xm, Mm^Xm, Mm^Xm, Ai, Mm^Xm, Mm^Xm
Mm, Ai, Ha^Fpa, Aa, Aa, Ai, Aa^Fpa, Aa, Aa^Fpa, Wwf, Gg^Efm, Gg^Efm, Cv, Cv, Cv, Xos, Rr, Aa, Xos, Ha^Fpa, Ha^Fpa, Mm, Mm, Mm^Xm, Mm^Xm, Ai, Mm^Xm, Mm^Xm
Mm, Mm, Mm, Aa, Aa^Fpa, Aa^Fpa, Re^Gvs, Aa^Fpa, Re^Gvs, Wwf, Gg^Efm, Gg^Efm, Rp, Rp, Rp, Rr, Rr, Rr, Rr, Aa, Aa, Aa^Fpa, Aa^Fpa, Mm, Mm^Xm, Ai, Mm^Xm, Mm^Xm
Mm, Mm, Aa^Fpa, Aa^Fpa, Re^Gvs, Re^Gvs, Re^Gvs, Re^Gvs, Re^Gvs, Wwf, Rp, Rp, Cv, 2 Kv, Rp, Aa, Xos, Rr, Rr, Rr, Rr, Xos, Aa, Mm, Mm, Mm^Xm, Mm, Mm^Xm
Aa^Fpa, Aa^Fpa, Re^Gvs, Re^Gvs, Re^Gvs, Re^Gvs, Re^Gvs, Re^Gvs, Wwf, Wwf, Wwf, Cv, Cv, Cv, Rp, Aa, Gs^Fp, Aa, Aa, Rr, Rr, Rr, Rr, Ha, Xos, Ha, Aa^Fpa, Mm
Re^Gvs, Re^Gvs, Re^Gvs, Re^Gvs, Re^Gvs, Re^Vc, Wwf, Wwf, Gs^Fp, Rp, Gs^Fp, Wwf, Wwf, Hh, Gs^Fp, Rp, Rp, Gg^Efm, Aa^Fpa, Xos, Uu, Rr, Rr, Rr, Rr, Gg^Efm, Aa^Fpa, Aa^Fpa
Hh, Re^Gvs, Re^Gvs, Re^Gvs, Wwf, Wwf, Gg^Efm, Gg^Efm, Gg^Efm, Rp, Gg^Efm, Gg^Efm, Gg^Ve, Wwf, Gg^Efm, Gg^Efm, Gg^Efm, Rp, Rp, Ha, Rr, Rr, Uu, Rr, Rr, Rr, Xos, Aa^Fpa
Mm, Gs^Fp, Wwf, Wwf, Gg^Efm, Gg^Efm, Gg^Efm, Gg^Efm, Gg^Efm, Rp, Gg^Efm, Gg^Efm, Hh, Wwf, Hh, Mm, Gg^Efm, Cv, Rp, Gg^Ve, Hh, Xos, Aa, Rr, Rr, Rr, Aa, Aa^Fpa
Wwf, Wwf, Hh, Gg^Efm, Hh, Hh^Fp, Gs^Fp, Gg^Efm, Rp, Rp, Gg^Efm, Gg^Efm, Ds, Wwf, Wwf, Gs^Fp, Gg^Efm, Gg^Efm, Gg^Efm, Rp, Rp, Gg^Efm, Aa, Rr, Rr, Rr, Aa^Fpa, Aa^Fpa
Wwf, Mm, Hh, Gg^Efm, Gg^Efm, Mm, Rp, Rp, Ss, Rp, Gs^Fp, Xos, Rr, Xos, Gg^Efm, Wwf, Wwf, Gg^Efm, Gs^Fp, Gs^Fp, Rp, Gs^Fp, Xos, Rr, Rr, Rr, Xos, Aa^Fpa
Mm, Wwf, Wwf, Gg^Efm, Rp, Rp, Gg^Efm, Gg^Ve, Gg^Efm, Rp, Hh, Ds, Xos, Hh, Gg^Efm, Gs^Fp, Ss^Vhs, Wwf, Ds, Mm, Rp, Aa, Aa, Rr, Rr, Rr, Aa^Fpa, Aa^Fpa
Hh, Gg^Ve, Rp, Wwf, Wwr, Gg^Efm, Gs^Fp, Gg^Efm, Gs^Fp, Rp, Rp, Gg^Efm, Gg^Efm, Gg^Efm, Gg^Efm, Hh, Wwf, Wwf, Wwf, Hh, Rp, Cv, Aa, Rr, Rr, Rr, Ha, Aa^Fpa
Hh, Gs^Fp, Rp, Gg^Efm, Gs^Fp, Wwf, Wwf, Mm, Hh, Gg^Efm, Cv, Rp, Rp, Gg^Efm, Wwf, Wwf, Gg^Efm, Hh, Gs^Fp, Wwf, Wwf, Aa^Fpa, Xos, Rr, Rr, Rr, Xos, Ha
Mm, Hh, Rp, Gg^Efm, Gg^Efm, Hh, Gg^Efm, Wwf, Ww, Ds, Ww, Ss, Ww^Bw|, Wwf, Rp, Gg^Efm, Xos, Mm, Gg^Efm, Rp, Xos, Wwf, Wwf, Rr, Wwf, Ch, Wo, Ai
Mm^Xm, Rp, Mm, Hh, Gs^Fp, Gg^Efm, Gg^Efm, Gg^Efm, Cv, Ww, Wo, Ww, Cv, Gs^Fp, Hh, Rp, Ds, Rr, Rr, Rr, Rr, Rr, Wwr, Wwf, Gg^Fet, Ww, Wo, Ai
Mm, Rp, Rp, Hh, Gg^Efm, Gg^Efm, Gg^Efm, Gg^Efm, Ww, Ww, Ww, Ww, Ww^Bw|, Gs^Fp, Rp, Rp, Xos, Rr, Gg^Efm, Rr, Xos, Rr, Wwf, Wwf, Wwf, Ww, Wo, Ai
Hh, Hh, Rp, Gg^Efm, Gs^Fp, Hh, Wwf, Wwf, Hh, Ds, Cv, Ss, Rp, Wwf, Wwf, Gg^Efm, Gg^Efm, Mm, Gs^Fp, Rp, Wwf, Wwf, Xos, Rr, Rr, Ch, Xos, Ai
Hh, Gs^Fp, Rp, Gg^Efm, Wwr, Wwf, Gs^Fp, Mm, Gs^Fp, Gg^Efm, Rp, Rp, Gg^Efm, Gg^Efm, Gg^Efm, Wwf, Wwf, Hh, Wwf, Wwf, Rp, Aa^Fpa, Aa, Rr, Rr, Rr, Ha, Ha
Mm, Gg^Ve, Wwf, Wwf, Rp, Gg^Efm, Gg^Efm, Gg^Efm, Gg^Efm, Rp, Hh, Gg^Efm, Xos, Gg^Efm, Gg^Efm, Hh, Ss^Vhs, Wwf, Ds, Hh, Rp, Cv, Aa, Rr, Rr, Rr, Aa^Fpa, Ha
Wwf, Wwf, Hh, Gg^Efm, Gg^Efm, Rp, Rp, Gg^Ve, Ss, Rp, Gs^Fp, Ds, Rr, Hh, Gg^Efm, Gs^Fp, Wwf, Wwf, Gs^Fp, Mm, Rp, Aa, Xos, Rr, Rr, Rr, Xos, Aa^Fpa
Wwf, Mm, Hh, Gg^Efm, Hh, Mm, Gs^Fp, Rp, Rp, Rp, Gg^Efm, Xos, Ds, Xos, Wwf, Wwf, Gg^Efm, Gg^Efm, Gg^Efm, Gs^Fp, Rp, Gs^Fp, Aa, Rr, Rr, Rr, Aa^Fpa, Aa^Fpa
Mm, Wwf, Wwf, Gg^Efm, Gg^Efm, Hh^Fp, Gg^Efm, Gg^Efm, Gg^Efm, Rp, Gg^Efm, Gg^Efm, Hh, Wwf, Hh, Gs^Fp, Gg^Efm, Gg^Efm, Rp, Rp, Hh, Gg^Efm, Aa, Rr, Rr, Rr, Aa, Aa^Fpa
Hh, Gs^Fp, Re^Gvs, Wwf, Wwf, Gg^Efm, Gg^Efm, Gg^Efm, Gg^Efm, Rp, Gg^Efm, Gg^Efm, Gg^Ve, Wwf, Gg^Efm, Mm, Gg^Efm, Cv, Rp, Gg^Ve, Rr, Xos, Uu, Rr, Rr, Rr, Xos, Aa
Re^Gvs, Re^Gvs, Re^Gvs, Re^Gvs, Re^Gvs, Wwf, Wwf, Gg^Efm, Gs^Fp, Rp, Gs^Fp, Gg^Efm, Wwf, Wwf, Gs^Fp, Gg^Efm, Rp, Rp, Aa^Fpa, Ha, Uu, Rr, Rr, Rr, Rr, Rr, Aa^Fpa, Aa^Fpa
Aa^Fpa, Re^Gvs, Re^Gvs, Re^Gvs, Re^Gvs, Gg^Vc, Re^Gvs, Wwf, Wwf, Rp, Wwf, Wwf, Cv, Hh, Rp, Rp, Gs^Fp, Gg^Efm, Aa, Xos, Rr, Rr, Rr, Rr, Xos, Gg^Efm, Aa^Fpa, Aa^Fpa
Ha^Fpa, Aa^Fpa, Aa^Fpa, Re^Gvs, Re^Gvs, Re^Gvs, Re^Gvs, Re^Gvs, Re^Gvs, Wwf, Rp, Cv, Cv, Cv, Rp, Aa, Xos, Aa, Rr, Rr, Rr, Rr, Ha, Aa, Ha, Aa, Mm, Mm
Mm, Ha^Fpa, Mm, Aa^Fpa, Aa^Fpa, Re^Gvs, Re^Gvs, Re^Gvs, Re^Gvs, Wwf, Gg^Efm, Rp, Rp, 1 Kv, Rp, Aa, Rr, Rr, Rr, Rr, Aa, Xos, Mm, Mm, Mm^Xm, Mm, Mm^Xm, Mm^Xm
Mm, Mm, Ai, Ha^Fpa, Ai, Aa^Fpa, Aa^Fpa, Aa^Fpa, Aa^Fpa, Wwf, Gg^Efm, Gg^Efm, Cv, Rp, Cv, Rr, Rr, Rr, Xos, Aa, Ha^Fpa, Aa^Fpa, Mm, Mm^Xm, Ai, Mm^Xm, Ai, Mm^Xm
Mm, Ai, Mm, Ai, Aa, Ai, Aa, Aa, Aa^Fpa, Wwf, Gg^Efm, Gg^Efm, Gg^Efm, Cv, Gg^Efm, Xu, Aa, Aa, Ha^Fpa, Ha^Fpa, Mm, Mm, Mm^Xm, Mm^Xm, Ai, Mm^Xm, Ai, Mm^Xm
Mm, Mm, Mm, Ai, Aa, Aa, Mm, Ha^Fpa, Aa^Fpa, Wwf, Aa, Gg^Efm, Aa, Gg^Efm, Aa^Vha, Aa, Aa^Fpa, Aa^Fpa, Mm, Mm, Mm^Xm, Mm^Xm, Mm^Xm, Mm^Xm, Ai, Ai, Ai, Mm^Xm
Mm, Mm, Mm, Ai, Mm, Mm, Mm, Mm, Aa^Fpa, Wwf, Aa, Aa, Aa, Aa, Aa^Fpa, Aa^Fpa, Mm, Mm, Mm^Xm, Mm^Xm, Mm^Xm, Mm^Xm, Mm^Xm, Mm^Xm, Ai, Mm^Xm, Ai, Mm^Xm
