border_size=1
usage=map

Xue, Xue, Xue, Xue, Xue, Xue, Xue, Xue, Xue, Xue, Xue, Xue, Xue, Xue, Xue, Xue, Xue, Xue, Xue, Xue, Xue, Xue, Xue, Xue, Xue, Xue, Xue
Xue, Xue, Xue, Xue, Xue, Xue, Wo, Xue, Wo, Xue, Uh^Tf, Wwf, Cud, Xue, Cud, Uh^Tf, Rr, Xue, Uh^Emf, Xue, Xue, Xue, Xue, Xue, Xue, Xue, Xue
Xue, Xue, Xue, Xue, Ww, Wo, Re, Wo, Ss^Emf, Uu^Tf, Uu, Wwf, 1 Kud, Xue, Cud, Re^Tf, Ur, Uu^Vud, Ur, Rr, Hhd^Fmf, Xue, Re^Emf, Xue, Xue, Xue, Xue
Xue, Xue, Xue, Uh, Wwf, Wwf, Hhd^Fmf, Hhd, Re, Re, Wwf, Wwf, Cud, Cud, Cud, Rr, Rd, Re^Fmf, Re, Rd, Rd, Hhd, Rd, Dd, Xue, Xue, Xue
Xue, Xue, Wo, Ww, Ww, Wwf, Re^Fdf, Rd, Wwf, Wwf, Re, Cud, Rr, Cud, Re, Rr, Rr, Rd, Rd, Md, Rd, Rd, Rd, Hhd, Gll^Fdf, Xue, Xue
Xue, Xue, Ww, Uh^Tf, Wwf, Ss, Rd, Rd^Vht, Wwf, Re, Rd, Rr, Rd, Rr, Re, Re, Re, Rd, Re, Hhd^Vhhr, Hhd, Chr, Rd, Rd, Rr, Xue, Xue
Xue, Uh^Tf, Wwf, Ww, Wwf, Rd, Wwf, Wwf, Rd, Re, Rd, Wwf, Xue, Xue, Xue, Md, Gll^Fmf, Rd, Re, Re, Re, Rd, Sm, Sm, Rd, Xue, Xue
Ss^Tf, Rd, Gll^Fmf, Wwf, Gll^Fdf, Wwf, Re, Re, Gll^Fmf, Rd, Md, Hhd^Tf, Ur, Ur, Wwf, Uu, Rd, Rd, Rd, Gll^Fmf, Rd, Dd, Re^Tf, Dd, Rd, Xue, Xue
Sm, Hhd, Rd, Ss, Rd^Ve, Re, Wwf, Rd, Rd, Wwf, Rd, Rr, Rr^Vd, Re^Tf, Hhd^Fmf, Xue, Rd, Re, Re, Rd, Rd, Rd^Vda, Rd, Rd, Re, Ss, Xue
Gll^Fdf, Rd, Re, Hhd, Wwf, Wwf, Wwf, Re, Re, Wwf, Re, Uh, Xue, Xue, Xue, Wwf, Re, Re^Vo, Rd, Re, Hhd^Fdf, Rr, Rd, Rd, Rd, Gll^Fdf, Xue
Gll^Fdf, Gll^Fmf, Md, Re, Rd, Rd, Wwf, Wwf, Ww, Wwf, Wwf, Xue, Qlf, Rd, Qxu, Xue, Rd, Rd, Rd, Rd, Rd, Rd, Rd, Hhd, Rr, Rd, Re^Tf
Ss, Hhd, Rd, Rd, Rd, Re, Re, Hhd, Ww, Ww, Wwf, Xue, Xue, Ql, Xue, Xue, Uh, Re, Rd, Rr, Dd, Dd, Rr, Chr, Rr, Re, Re
Chr, Re, Rd, Rd, Hhd^Fmf, Ss, Rd, Chr, Chr, Rd, Ww, Wwf, Ww, Xue, Re^Tf, Rr, Rd, Gll^Fmf, Re, Rd, Md, Rd, Re, Rd, Rr, Hhd^Fdf, Rr
Rr, Chr, Rr, Re, Re, Rd, Md, Rd, Re, Re, Rd, Gll^Fdf, Re^Tf, Wwf, Ww, Gll^Fdf, Ww, Re, Chr, Rd, Rd, Rd, Hhd^Fmf, Re, Rd, Chr, Chr
Re, Hhd^Fdf, Rr, Rd, Rr, Rd, Dd, Rd, Rd, Gll^Fmf, Uh, Rr, Xue, Xue, Xue, Wwf, Wwf, Rd, Ww, Chr, Re, Ss, Rd, Rd, Rd, Re, Ss
Re^Tf, Re, Rr, Chr, Rd, Dd, Rd, Rr, Rd, Re, Rd, Xue, Qxu, Ql, Qlf, Xue, Wwf, Ww, Ww, Hhd, Wwf, Re, Rd, Rd, Md, Hhd, Gll^Fdf
Xue, Rd, Rd, Hhd, Rd, Rd, Hhd^Fdf, Rd, Rd, Rd, Re, Xue, Xue, Rd, Xue, Xue, Re, Wwf, Re, Wwf, Wwf, Rd, Wwf, Re, Re, Gll^Fmf, Gll^Fdf
Xue, Gll^Fdf, Re, Rd, Rd, Rr, Rd, Re, Re, Re^Vo, Rd, Wwf, Hhd^Fmf, Xue, Rr^Vd, Uh, Rd, Wwf, Rd, Re, Wwf, Wwf, Rd^Ve, Hhd, Rd, Rd, Sm
Xue, Ss, Rd, Rd, Re^Tf, Rd^Vda, Rd, Rd, Rd, Re, Rd, Xue, Wwf, Re^Tf, Ur, Rr, Md, Wwf, Gll^Fmf, Rd, Re, Re, Gll^Fdf, Ss, Gll^Fmf, Hhd, Ss^Tf
Xue, Xue, Rd, Dd, Sm, Dd, Re, Gll^Fmf, Re, Rd, Gll^Fmf, Uu, Xue, Ur, Xue, Hhd^Tf, Rd, Rd, Rd, Re, Wwf, Wwf, Wwf, Wwf, Wwf, Rd, Xue
Xue, Xue, Rr, Sm, Rd, Rd, Hhd, Re, Re, Rd, Re, Md, Re, Xue, Rd, Wwf, Rd, Re, Wwf, Wwf, Rd, Rd, Wwf, Ww, Ww, Uh^Tf, Xue
Xue, Xue, Gll^Fdf, Rd, Rd, Chr, Rd, Hhd^Vhhr, Rd, Rd, Rr, Re, Re, Rr, Rr, Rr, Re, Re, Wwf, Rd^Vht, Re^Fdf, Ss, Ww, Uh^Tf, Wo, Xue, Xue
Xue, Xue, Xue, Hhd, Rd, Rd, Rd, Md, Re, Rd, Rd, Rr, Cud, Cud, Cud, Cud, Wwf, Wwf, Re, Rd, Hhd^Fmf, Wwf, Wwf, Ww, Xue, Xue, Xue
Xue, Xue, Xue, Dd, Re^Emf, Hhd, Hhd^Fmf, Rd, Ur, Re^Fmf, Ur, Rr, Cud, Cud, 2 Kud, Wwf, Uu, Re, Ss^Emf, Hhd, Re, Wwf, Ww, Uh, Xue, Xue, Xue
Xue, Xue, Xue, Xue, Xue, Xue, Xue, Rr, Uh^Emf, Uu^Vud, Rr, Re^Tf, Cud, Xue, Cud, Wwf, Uh^Tf, Uu^Tf, Wo, Wo, Wo, Wo, Xue, Xue, Xue, Xue, Xue
Xue, Xue, Xue, Xue, Xue, Xue, Xue, Xue, Xue, Xue, Xue, Uh^Tf, Xue, Xue, Xue, Wwf, Xue, Xue, Xue, Xue, Xue, Xue, Xue, Xue, Xue, Xue, Xue
Xue, Xue, Xue, Xue, Xue, Xue, Xue, Xue, Xue, Xue, Xue, Xue, Xue, Xue, Xue, Xue, Xue, Xue, Xue, Xue, Xue, Xue, Xue, Xue, Xue, Xue, Xue
