border_size=1
usage=map

Gll^Fp      , Wwg         , Gll^Fp      , Ce          , Ce          , Ce          , Ce          , Ce          , Md          , Hhd^Fdw     , Hhd         , Hhd         , Gll^Fp      , Gll         , Gll         , Gll^Fp      , Gll^Fmw     , Hhd^Fp      , Hhd^Fmw     , Hhd^Fdw     , Wwf         , Rb^Uf       , Gll^Fp      , Sm^Uf       , Sm^Uf       , Sm          , Gll^Fp      , Gll^Fdw     , Hhd^Fdw     , Hhd         , Md          , Md          
Hhd^Uf      , Gd          , Gd          , Gll^Fmw     , Ce          , 1 Ke        , Ce          , Ce          , Gd^Em       , Gll         , Gll^Em      , Hhd         , Rb^Uf       , Gll^Em      , Gd^Em       , Gd          , Wwf         , Md          , Wwf         , Wwf         , Chr         , Wwf         , Wwf         , Gll^Fmw     , Hhd^Fdw     , Hhd         , Gll         , Gd          , Gd          , Gll^Em      , Gll^Em      , Hhd         
Wwg         , Gd^Em       , Gd^Em       , Gd          , Ce          , Ce          , Gd          , Gd^Em       , Rb^Es       , Gll         , Ur^Vhr      , Ss          , Wwf         , Gll         , Wwf         , Wwf         , Chr         , Wwf         , Rp^Fdw      , Chr         , Rp^Es       , Chr         , Rp^Es       , Wwg^Ewl     , Wwg^Ewl     , Md          , Gll^Em      , Gll^Fmw     , Gd          , Gd          , Gd          , Gd          
Wwg         , Gll^Em      , Gd          , Gll         , Gd          , Gll         , Gll         , Rb^Es       , Rb^Es       , Ur^Gvs      , Ur^Gvs      , Wwf         , Wwg^Ewl     , Wwf         , Ss          , Khs         , Chr         , Wwf         , Wwf         , Rp          , Rp          , Rp^Es       , Rp          , Wwg^Ewl     , Chr         , Wwf         , Wwf         , Gd          , Gll         , Gd^Em       , Hhd^Uf      , Hhd^Fp      
Ur^Gvs      , Hhd         , Gll         , Gd          , Gd          , Gd^Em       , Hhd^Fmw     , Ur^Gvs      , Hhd         , Rb^Es       , Wwf         , Wwg^Ewl     , Rb^Dr       , Wwf         , Rp          , Chs         , Rp          , Rp^Es       , Wwf         , Rb^Dr       , Rp^Vhcr     , Rp^Es       , Rp          , Rp          , Rp^Es       , Khr         , Chr         , Wwf         , Gll         , Gll         , Wwg^Ewl     , Wwg^Ewl     
Rb^Es       , Rb^Gvs      , Rb^Es       , Gll^Vhr     , Gd          , Gd          , Hhd^Fdw     , Md          , Wwg^Ewl     , Wwf         , Chr         , Rp^Es       , Rp          , Rp^Vhhr     , Rp          , Rp^Es       , Rp          , Rb^Fdw      , Wwf         , Rp^Es       , Rp^Es       , Rp^Es       , Sm^Fdw      , Rp          , Rp^Es       , Chr         , Rb^Fdw      , Wwf         , Wwg^Ewl     , Wwg^Ewl     , Ss          , Ss          
Ur^Gvs      , Ur^Gvs      , Rb^Gvs      , Gll^Fp      , Gd          , Gd          , Wwf         , Wwg^Ewl     , Wwg^Ewl     , Chr         , Rp^Es       , Rp          , Rb^Uf       , Rp^Es       , Rp          , Rp          , Rp^Es       , Wwf         , Uh^Uf       , Rp          , Rp          , Rp          , Rp          , Rp          , Rp^Es       , Rp          , Wwf         , Wwf         , Rb^Es       , Rb^Gvs      , Md          , Ss          
Rb^Es       , Ur^Gvs      , Gd^Em       , Gd          , Gd          , Wwf         , Rp^Es       , Rp          , Rp^Vhcr     , Rp          , Rp^Es       , Rp^Es       , Rp          , Rp          , Rp^Es       , Rp          , Sm^Dr       , Wwg         , Chr         , Chr         , Rp^Fdw      , Rp          , Rp          , Rp          , Rp          , Rp^Es       , Chs         , Wwf         , Ur^Vhr      , Ur^Gvs      , Ur^Gvs      , Hhd^Fdw     
Wwg         , Rb^Gvs      , Hhd^Uf      , Gd          , Wwf         , Wwf         , Rp          , Rp^Es       , Rp          , Rb^Fdw      , Rp          , Rp          , Rp          , Rp^Es       , Rp^Es       , Rp^Es       , Wwg         , Wwg         , Wwf         , Chr         , Rp          , Rp          , Rp^Vhhr     , Rb^Dr       , Rp^Es       , Rp          , Rp^Fdw      , Wwg         , Ur^Es       , Ur^Gvs      , Rb^Es       , Wwg         
Wwg         , Wwg         , Wwg         , Wwg^Bw|     , Chw         , Khw         , Chr         , Rp          , Rp^Es       , Rp          , Chr         , Sm          , Wwg^Ewl     , Wwf         , Wwf         , Wwf^Vhcr    , Rp          , Rp          , Rp          , Wwf         , Rp          , Rp^Es       , Rp          , Rp          , Rp          , Rp          , Rp^Es       , Wwg         , Wwf         , Gd          , Gd^Em       , Gll^Em      
Hhd^Fdw     , Wwg         , Wwg^Bw/     , Wwg^Bw|     , Wwf         , Chr         , Rp^Es       , Rp          , Rb^Dr       , Rp^Es       , Chw         , Wwg^Ewl     , Rp          , Rb^Uf       , Rp          , Rp          , Rp          , Rp^Fdw      , Rp          , Wwg         , Sm          , Rp^Es       , Rp          , Rp          , Rp          , Rp^Es       , Rp^Es       , Rp          , Wwf         , Gll^Fmw     , Gll^Em      , Gd^Em       
Hhd         , Gd^Em       , Gd          , Wwg^Ewl     , Wwf         , Wwf         , Wwf         , Rp          , Wwg         , Rb^Uf       , Wwf         , Wwf         , Rp          , Rp^Es       , Rp          , Rp          , Rp          , Rp^Es       , Rp          , Wwg         , Wwg         , Wwg         , Chw         , Rp          , Rb^Dr       , Rp          , Khr         , Chr         , Chr         , Wwf         , Gd          , Gll         
Ss          , Gd          , Gd          , Hhd^Fmw     , Wwf         , Rb^Fdw      , Rp^Es       , Wwg         , Sm          , Wwg         , Wwg         , Uh^Dr       , Rp          , Rp^Es       , Khr         , Rp^Es       , Rp          , Rp          , Rb^Dr       , Rp          , Rp          , Wwf         , Wwf         , Rb^Uf       , Rp^Fdw      , Rp          , Rp          , Chr         , Wwf         , Wwf         , Gd          , Hhd^Fdw     
Rb^Uf       , Gll^Fp      , Gd          , Wwf         , Chr         , Rp          , Rp^Vhhr     , Rp          , Rp          , Rp          , Rp^Es       , Wwg         , Rp^Es       , Rp          , Wog         , Rp          , Rp          , Khr         , Rp^Es       , Rp          , Rp^Es       , Rb^Dr       , Wwf         , Rp          , Rp          , Rp^Es       , Rp          , Rp          , Wwf         , Rb^Uf       , Gll^Fp      , Gll^Fmw     
Ss          , Gd^Em       , Gd^Em       , Wwf         , Wwg         , Rp          , Rp^Es       , Rp          , Rp          , Rp^Fdw      , Rp^Es       , Wwf         , Rb^Fdw      , Rp          , Wog^Bsb|    , Wwf         , Wwf         , Wog^Bsb|    , Wog         , Wwf         , Wwf         , Wwf         , Rp^Es       , Rp          , Rp          , Rp          , Rb^Dr       , Wwg         , Hhd         , Md          , Gd          , Wwg         
Ss          , Gd^Em       , Md          , Hhd         , Wwg         , Rb^Dr       , Rp          , Rp^Es       , Rp          , Rp          , Wwf         , Wwf         , Wwf         , Wog         , Wog^Bsb|    , Wwf         , Wwf         , Wog^Bsb|    , Rp          , Rb^Fdw      , Wwf         , Rp          , Rb^Fdw      , Rp          , Rp          , Rp          , Rp          , Wwg         , Wwf         , Gd          , Gd          , Gll^Fdw     
Gll^Fdw     , Gll^Fdw     , Hhd^Uf      , Wwf         , Rp          , Rp          , Rp          , Rp          , Rp          , Wwf         , Rb^Dr       , Rp          , Rp^Es       , Rp          , Khr         , Rp          , Rp          , Wog         , Rp^Es       , Rp          , Wwg         , Rp^Es       , Rp          , Rp^Es       , Rp^Es       , Rp^Vhcr     , Rp          , Chr         , Wwf         , Gll^Em      , Gll^Fmw     , Gd          
Gll^Fmw     , Gll         , Wwf         , Wwf         , Chr         , Rp          , Rp          , Rb^Fdw      , Rb^Uf       , Wwf         , Wwf         , Rp^Es       , Rp          , Rb^Dr       , Rp          , Rp          , Rp          , Khr         , Rp          , Rp          , Uh^Dr       , Wwg         , Wwg         , Sm          , Wwg         , Rp          , Rb^Fdw      , Wwf         , Hhd^Fmw     , Gll         , Gd          , Gd          
Gd          , Gd          , Wwf         , Chr         , Chr         , Khr         , Rp          , Rb^Dr       , Rp          , Chw         , Wwg         , Wwg         , Wwg         , Rp          , Rp          , Rp^Es       , Rp^Es       , Rp          , Rp^Es       , Rp          , Wwf         , Wwf         , Rb^Uf       , Wwg         , Rp          , Wwf         , Wwf         , Wwf         , Wwg^Ewl     , Gd          , Gd^Em       , Gll^Em      
Gll^Em      , Gd          , Gll^Fmw     , Wwf         , Rp          , Rp          , Rp          , Rp^Es       , Rp          , Rp          , Rp          , Sm          , Wwg         , Rp          , Rp^Fdw      , Rp^Es       , Rp          , Rp          , Rb^Uf       , Rp          , Wwg^Ewl     , Chw         , Rp          , Rb^Dr       , Rp          , Rp          , Chr         , Wwf         , Wwg^Bw|     , Wwg^Bw/     , Wwg         , Hhd^Fp      
Hhd         , Gd          , Ur^Gvs      , Wwf         , Wwg         , Rp          , Rp          , Rp          , Rp          , Rp^Es       , Rp          , Rp          , Wwf         , Rp^Es       , Rp^Es       , Rp          , Wwf^Vhcr    , Wwf         , Wwf         , Wwg^Ewl     , Sm          , Chr         , Rp          , Rp^Es       , Rp          , Chr         , Khw         , Chw         , Wwg^Bw|     , Wwg         , Wwg         , Wwg         
Wwg         , Rb^Gvs      , Ur^Gvs      , Ur^Gvs      , Wwg         , Rp^Fdw      , Rp          , Rp          , Rb^Dr       , Rp^Vhcr     , Rp          , Rp          , Chr         , Wwf         , Wwg         , Wwg         , Rp          , Rp^Es       , Rp^Es       , Rp^Es       , Rp          , Rp          , Rb^Fdw      , Rp^Es       , Rp^Es       , Rp^Es       , Wwf         , Wwf         , Gd          , Gd^Em       , Gll^Em      , Wwg         
Hhd^Fmw     , Rb^Es       , Rb^Es       , Gll^Vhr     , Wwf         , Chs         , Rp          , Rp^Es       , Rp          , Rp^Es       , Rp          , Rp^Fdw      , Chr         , Chr         , Wwg         , Sm^Dr       , Rp          , Rp          , Rp          , Rp          , Rp          , Rp          , Rp          , Rp^Vhcr     , Rp          , Rp          , Wwf         , Hhd^Uf      , Gd          , Gd          , Gd          , Hhd^Fmw     
Hhd         , Md          , Ur^Es       , Rb^Gvs      , Wwf         , Wwf         , Rp          , Rp          , Rp          , Rp          , Rp          , Rp          , Rp          , Uh^Uf       , Wwf         , Rp          , Rp^Es       , Rp^Es       , Rp          , Rb^Uf       , Rp          , Rp^Es       , Chr         , Wwg^Ewl     , Wwg^Ewl     , Wwf         , Gll^Em      , Gll         , Gll^Fp      , Gd          , Rb^Gvs      , Ur^Gvs      
Ss          , Ss          , Wwg^Ewl     , Wwg^Ewl     , Wwf         , Rp^Fdw      , Chr         , Rp          , Rp^Es       , Sm^Fdw      , Rp          , Rp          , Rp          , Wwf         , Rb^Fdw      , Rp          , Rp^Es       , Rp          , Rp^Vhhr     , Rp          , Rp          , Chr         , Wwf         , Wwg^Ewl     , Md          , Hhd^Fmw     , Gll^Em      , Gd^Em       , Gll^Vhr     , Rb^Es       , Ur^Es       , Rb^Es       
Ss          , Wwg^Ewl     , Gll         , Gll^Em      , Wwf         , Chr         , Khr         , Rp^Es       , Rp          , Rp          , Rp          , Rp^Vhcr     , Rb^Dr       , Wwf         , Rp          , Rp          , Chs         , Rp          , Wwf         , Rb^Dr       , Wwg^Ewl     , Wwf         , Gll         , Hhd         , Gd          , Hhd^Fdw     , Gd          , Gd          , Gll         , Rb^Es       , Hhd         , Rb^Gvs      
Md          , Rb^Uf       , Gd          , Gd          , Gll         , Wwf         , Wwf         , Chr         , Wwg^Ewl     , Rp          , Rp^Es       , Rp          , Rp          , Wwf         , Wwf         , Chr         , Khs         , Ss          , Wwf         , Wwg^Ewl     , Wwf         , Gll         , Gll^Em      , Gll         , Gd          , Gd^Em       , Gd          , Gd          , Gd          , Gd          , Gd          , Ss          
Hhd         , Gll         , Gd          , Gll^Fmw     , Gd          , Gll^Em      , Md          , Wwg^Ewl     , Wwg^Ewl     , Rp          , Chr         , Rp^Es       , Chr         , Rp^Fdw      , Wwf         , Chr         , Wwf         , Wwf         , Gd          , Wwf         , Ss          , Ur^Vhr      , Ur^Gvs      , Ur^Gvs      , Gll         , Gd^Em       , Ce          , Ce          , Gd          , Gd^Em       , Gd          , Ss          
Hhd^Fp      , Gll^Em      , Gll         , Gd          , Gd          , Gd          , Hhd         , Hhd^Fp      , Gll^Fmw     , Wwf         , Wwf         , Chr         , Wwf         , Wwf         , Md          , Wwf         , Gll^Em      , Gll^Em      , Gd          , Rb^Uf       , Hhd         , Ur^Es       , Rb^Es       , Ur^Gvs      , Ce          , Ce          , 2 Ke        , Ce          , Gll^Fmw     , Gll^Em      , Gll         , Wwg         
Md          , Gll^Fp      , Gll^Fmw     , Ss          , Ss          , Gll^Fdw     , Hhd^Fmw     , Gll^Fp      , Hhd         , Hhd^Uf      , Hhd         , Wwf         , Hhd         , Hhd         , Hhd^Fdw     , Gll^Fmw     , Hhd         , Hhd^Fp      , Hhd         , Md          , Md          , Hhd         , Gll^Fp      , Gll^Fmw     , Ce          , Ce          , Ce          , Ce          , Ce          , Hhd         , Hhd^Fmw     , Rb^Uf       
