Wwg         , Mm^Xm       , Mm^Xm       , Mm^Xm       , Mm^Xm       , Mm^Xm       , Mm^Xm       , Mm^Xm       , Mm^Xm       , Mm^Xm       , Mm^Xm       , Mm^Xm       , Mm^Xm       , Mm^Xm       , Mm^Xm       , Mm^Xm       , Re          , Mm^Xm       , Mm^Xm       , Mm^Xm       , Wog         , Mm^Xm       , Mm^Xm       , Mm^Xm       , Mm^Xm       , Mm^Xm       , _off^_usr          , _off^_usr          , _off^_usr          , _off^_usr          , _off^_usr          , _off^_usr          , _off^_usr          , _off^_usr          , _off^_usr          
Mm^Xm       , Wwg         , Hh^Fms      , Mm^Xm       , Gs^Em       , Mm^Xm       , Ss          , Mm^Xm       , Hh          , Mm^Xm       , Hh^Tf       , Mm^Xm       , Gd          , Mm^Xm       , Hh          , Mm^Xm       , Re          , Mm^Xm       , Hh^Fp       , Mm^Xm       , Wog         , Mm^Xm       , Hh          , Mm^Xm       , Gs^Fp       , Mm^Xm       , Mm^Xm       , _off^_usr          , _off^_usr          , _off^_usr          , _off^_usr          , _off^_usr          , _off^_usr          , _off^_usr          , _off^_usr          
Wwg         , Wwg         , Gs^Fmw      , Gs^Fmf      , Gs          , Gs          , Gs          , Ss          , Gd          , Hh^Tf       , Hh^Fms      , Gs          , Gs          , Gd          , Gs          , Ce          , 1 Ket       , Ce          , Wwf         , Wwf         , Gs^Em       , Re^Tf       , Hh          , Hh^Fms      , Gd          , Gd          , Gs^Em       , Mm^Xm       , Mm^Xm       , _off^_usr          , _off^_usr          , _off^_usr          , _off^_usr          , _off^_usr          , _off^_usr          
Gs^Fms      , Wwg         , Wwg         , Gd^Vhc      , Gd          , Gs          , Gs^Em       , Gs          , Gd          , Hh^Fp       , Hh          , Gs^Em       , Gs          , Gs^Efm      , Gs          , Ce          , Ce          , Ce          , Wwf         , Gs          , Gs          , Gs^Efm      , Gs          , Mm          , Gs          , Gd          , Gs          , Hh          , Hh^Fp       , Mm^Xm       , Mm^Xm       , _off^_usr          , _off^_usr          , _off^_usr          , _off^_usr          
Gs^Fmw      , Gs^Fp       , Gs          , Wwf         , Gd^Em       , Gs^Efm      , Gs          , Gs          , Gd          , Gd          , Gs          , Gs^Vl       , Gs^Fmf      , Gs          , Gs          , Gs          , Gs          , Gs^Fmw      , Wwg         , Gs          , Gd^Em       , Gs          , Gs          , Gs          , Gs          , Gs          , Ket         , Rb^Tf       , Gs^Fmw      , Gs^Efm      , Gs          , Mm^Xm       , Mm^Xm       , _off^_usr          , _off^_usr          
Re^Tf       , Gs^Fmf      , Gs          , Wwf         , Wwf         , Ce          , Ket         , Gs          , Gs          , Gs          , Gs^Efm      , Gs          , Rb^Tf       , Gs          , Gd          , Gs          , Gd          , Gs          , Gs          , Wwg         , Wwg         , Gd^Vhc      , Gs          , Gs          , Gd          , Ce          , Ce          , Ce          , Gs          , Gs^Em       , Gs          , Hh          , Ss          , Mm^Xm       , Mm^Xm       
Re^Tf       , Rb^Tf       , Gs          , Hh          , Wwf         , Ce          , Ce          , Gs          , Gs^Fms      , Gs^Fmw      , Ss          , Gs          , Gs          , Gs          , Gs          , Gd          , Gd          , Gs^Em       , Gs          , Gs^Fp       , Gs^Fms      , Wwg         , Wwf         , Gd          , Gd^Em       , Gs          , Hh          , Gs^Fms      , Gd          , Gd          , Gs          , Gs          , Re^Tf       , Ss          , Ss          
Gs          , Gd^Em       , Gs          , Gd          , Gd          , Wwg         , Wwg         , Gs^Em       , Gs          , Mm^Xm       , Ss          , Gd^Em       , Gs          , Gs^Em       , Hh          , Mm^Vud      , Mm^Xm       , Ss          , Re^Tf       , Gs          , Gs^Efm      , Gs          , Wwf         , Gs          , Gs          , Gd          , Gs          , Gd          , Gd          , Gd          , Gs          , Gs^Efm      , Gs          , Hh^Fmf      , Ss          
Gs          , Gs          , Gs^Fms      , Gd^Em       , Wwf         , Wwg         , Wwg         , Gs          , Gs^Efm      , Mm^Xm       , Mm          , Gs^Efm      , Gd          , Gd          , Gd          , Mm^Xm       , Mm^Xm       , Mm^Xm       , Gs^Em       , Gs          , Gs          , Gs          , Hh^Fp       , Wwf         , Gs^Fmf      , Gs          , Gs          , Gd          , Gs^Fp       , Hh^Fmw      , Gs          , Gs          , Gs          , Gd          , Mm          
Gd          , Gs^Efm      , Wwg         , Wwg         , Gs          , Gd^Vud      , Gd          , Wwf         , Wwf         , Hh^Fms      , Hh^Vhh      , Gd          , Gd          , Gd          , Gs          , Mm^Xm       , Wog         , Mm^Xm       , Gs          , Gs          , Wwg         , Wwg         , Wwg         , Wwg         , Wwg         , Gs^Fms      , Ss^Vhs      , Gs          , Hh          , Mm          , Wwg         , Gs^Em       , Gd          , Gd          , Mm          
Mm          , Hh          , Wwf         , Gs^Em       , Gs          , Gs          , Gd          , Gd^Em       , Wwg         , Mm^Xm       , Hh          , Gs          , Gs          , Gs          , Gs          , Gs^Fp       , Wog         , Hh^Fmw      , Wwf         , Wwf         , Gs          , Gs          , Gs          , Gs          , Gs          , Wwf         , Wwf         , Wwf         , Wwf         , Wwg         , Gs          , Wwg         , Wwf         , Hh          , Ss          
Mm          , Wwf         , Mm          , Hh^Tf       , Gs^Fmf      , Gd          , Gs          , Gs          , Wwg         , Mm^Xm       , Mm^Xm       , Gs^Fmw      , Gs          , Gs^Em       , Gs^Efm      , Gs^Fmf      , Gs          , Wwf         , Gd          , Hh          , Mm^Xm       , Gs^Efm      , Hh^Tf       , Gs^Em       , Gd          , Gs^Fmw      , Wwf         , Gd          , Gs          , Gs          , Ce          , Re^Tf       , Ce          , Wwf         , Ss          
Mm          , Wwf         , Wwf         , Hh^Fmw      , Gs          , Gs          , Gd^Em       , Gs^Fmw      , Hh          , Wwg         , Wwf         , Hh^Tf       , Mm          , Gs          , Gd          , Gd          , Gd          , Gd          , Gs          , Ss          , Hh^Fmf      , Mm^Xm       , Hh^Vl       , Gd          , Gd          , Gs^Fp       , Wwg         , Gs^Em       , Gs^Efm      , Gs          , Gd          , Ket         , Gs^Fmw      , Wwf         , Wwf         
Hh          , Hh          , Wwf         , Gs^Efm      , Gs          , Gd          , Gs          , Gs          , Gs          , Gd          , Gd^Em       , Wwf         , Hh^Fp       , Gs^Em       , Gs          , Gs          , Gs          , Gs          , Gs          , Gs          , Gd          , Gs          , Wwg         , Hh          , Gs          , Gs          , Wwg         , Hh^Fp       , Gd          , Gd^Vh       , Gd          , Ce          , Gs^Fp       , Ss          , Wwf         
Gs^Efm      , Gs          , Re^Tf       , Wwf         , Gs          , Hh          , Gs^Fms      , Gs          , Gs          , Gd          , Wog         , Wwf         , Hh^Fms      , Ss          , Rb^Tf       , Gs          , Gs^Em       , Gs^Em       , Gs^Em       , Gd          , Gd          , Gd          , Wwg         , Wog         , Wwf         , Wwf         , Gs          , Wwg         , Wwf         , Gd          , Wwf         , Gs          , Wwf         , Wwf         , Gs          
Gd          , Gd^Em       , Wwf         , Wwf         , Wwf         , Wwf         , Wwf         , Gs^Fp       , Gs          , Gs          , Wwf         , Wog         , Wwg         , Wwg         , Gd          , Gs          , Gs^Em       , Gs^Efm      , Gs^Em       , Gs          , Rb^Tf       , Wwg         , Hh^Fmw      , Wog         , Wog         , Gd^Em       , Gd          , Gs^Fmw      , Gs^Fms      , Wwf         , Gd^Em       , Wwf         , Rb^Tf       , Gs          , Gd          
Wwf         , Wwf         , Gs^Fmf      , Gs          , Gd          , Gs          , Gs^Em       , Wwg         , Wwg         , Wwf         , Gs^Efm      , Wog         , Wwg         , Gs          , Gs          , Gs          , Gs          , Gs^Em       , Gs          , Gd          , Gd          , Ss          , Hh^Fms      , Wwf         , Gs^Efm      , Gd          , Gd          , Gs          , Gs          , Hh          , Gs          , Wwf         , Wwf         , Gd^Em       , Gd          
Wwf         , Ss          , Gs^Fp       , Co          , Gs          , Gs^Vo       , Gs          , Hh^Fmf      , Wwg         , Gd          , Gs          , Hh          , Hh^Vd       , Gs          , Hh^Fp       , Gs          , Gs          , Gd          , Gs          , Gd          , Gs          , Gd          , Mm          , Wwf         , Wwf         , Gs          , Hh          , Gs          , Gs^Efm      , Gs          , Gs          , Gs          , Wwf         , Hh          , Mm          
Ss          , Wwf         , Co          , Ko          , Co          , Gs          , Gd          , Gd          , Wwf         , Gs^Fms      , Gs          , Gs          , Hh^Tf       , Mm^Xm       , Mm^Xm       , Ss          , Gd^Em       , Gs          , Gd          , Gd          , Gs          , Gs^Em       , Gs          , Hh^Tf       , Mm^Xm       , Wwg         , Wwg         , Gs^Fmf      , Gd          , Gd          , Gs^Fp       , Hh^Fmf      , Mm          , Wwf         , Mm          
Ss          , Wwf         , Wwf         , Rb^Tf       , Gd^Em       , Gs^Efm      , Wwf         , Gd          , Wwf         , Gs^Fmw      , Gs          , Gs          , Gd          , Gd          , Gd          , Hh          , Wwf         , Wwf         , Wog         , Gs^Fp       , Gs          , Gs          , Gd          , Gs^Fmf      , Hh          , Mm^Xm       , Wwg         , Gs^Em       , Gs          , Gd          , Gd          , Hh^Tf       , Wwf         , Wwf         , Mm          
Mm          , Hh          , Gd          , Wwg         , Wwg         , Wwg         , Hh          , Wwf         , Ss^Vht      , Wwf         , Wwg         , Gs^Em       , Wwg         , Gd          , Wwg         , Wwf         , Gs          , Hh^Fmf      , Wog         , Gs^Fms      , Gs          , Gs^Efm      , Gd          , Gd          , Hh^Vda      , Mm^Xm       , Wwf         , Gs          , Gd          , Gs          , Gd          , Gd          , Wwg         , Hh          , Hh          
Mm          , Gd          , Gd^Em       , Gd          , Gd          , Mm          , Gs^Fmf      , Gs          , Gs          , Gs^Fms      , Gs^Fp       , Wwg         , Hh^Fms      , Wwg         , Gs          , Gs          , Gs^Efm      , Mm^Xm       , Mm^Xm       , Mm^Xm       , Gs          , Gs          , Gs          , Gs          , Mm          , Hh^Fp       , Gd          , Wwf         , Wwg         , Gd^Vu       , Wwf         , Wwg         , Gs^Fmw      , Gd^Em       , Gd          
Ss          , Gd          , Gs          , Gd          , Gs          , Hh^Fp       , Gs          , Gs          , Gs          , Gs          , Gd          , Wwf         , Wwf         , Gs          , Gd          , Gd          , Re^Tf       , Mm^Xm       , Mm^Xm       , Mm^Xm       , Hh          , Gd          , Gs          , Gs          , Ss          , Mm^Xm       , Gs^Em       , Gd          , Wwg         , Wwg         , Gs          , Gs^Efm      , Gs          , Gd          , Gs          
Ss          , Hh^Fms      , Re^Tf       , Gs          , Gs^Efm      , Gd          , Gs^Em       , Gs          , Hh          , Gs          , Gd          , Gd          , Wwf         , Gs          , Gs^Fp       , Gd^Em       , Gd          , Ss          , Gs          , Mm^Vu       , Gd          , Gd^Em       , Gs          , Gs          , Ss          , Mm^Xm       , Gs^Fms      , Gs          , Co          , Wwg         , Wwf         , Gs          , Gs          , Gd          , Rb^Tf       
Mm^Xm       , Ss          , Ss          , Gs          , Gs          , Gd          , Gd          , Gs^Fms      , Co          , Gs          , Gs^Em       , Gd          , Gs          , Wwg         , Wwg         , Gs^Fmw      , Gs          , Gs          , Gs          , Gs          , Gs          , Gd          , Rb^Tf       , Gs          , Gs^Em       , Gs^Fp       , Gs          , Gs          , Ko          , Co          , Wwf         , Hh          , Gs          , Re^Tf       , Rb^Tf       
_off^_usr          , Mm^Xm       , Mm^Xm       , Hh          , Gd          , Gd          , Gs^Fp       , Co          , Ko          , Co          , Gs          , Gs^Efm      , Gs          , Gd^Vo       , Gd^Em       , Wwg         , Wwg         , Gs          , Gs          , Gs          , Gd          , Gs^Efm      , Gs^Fms      , Gs          , Gs          , Gs          , Gd          , Gs          , Gs          , Co          , Gd^Em       , Wwf         , Gs          , Gs^Fms      , Gs^Fmf      
_off^_usr          , _off^_usr          , _off^_usr          , Mm^Xm       , Mm^Xm       , Gd          , Hh^Fmf      , Rb^Tf       , Gs^Em       , Gs          , Gs          , Gs          , Gs          , Gd          , Gd          , Gs^Efm      , Wwf         , Gs^Fp       , Co          , Gs          , Gs          , Gd          , Gd          , Gs^Vc       , Hh          , Gs          , Gs          , Gs^Efm      , Gs          , Gd          , Gd          , Wwf         , Wwg         , Gs^Fmw      , Gs^Fp       
_off^_usr          , _off^_usr          , _off^_usr          , _off^_usr          , _off^_usr          , Mm^Xm       , Mm^Xm       , Hh          , Gs          , Gs          , Gd          , Mm          , Hh          , Gs          , Gs          , Gs          , Wwf         , Co          , 2 Ko        , Co          , Gs          , Gd          , Gs          , Gs          , Hh^Fp       , Hh^Fmf      , Gs^Em       , Gd          , Gd          , Gs          , Gs          , Gd^Vd       , Gs^Fp       , Wwg         , Wwg         
_off^_usr          , _off^_usr          , _off^_usr          , _off^_usr          , _off^_usr          , _off^_usr          , _off^_usr          , Mm^Xm       , Mm^Xm       , Gd          , Gs^Fmf      , Hh^Fp       , Hh          , Rb^Tf       , Wog         , Wwf         , Hh^Fp       , Co          , Rb          , Co          , Hh          , Gs^Em       , Gs          , Gs          , Hh^Tf       , Hh^Tf       , Hh          , Ss          , Ss          , Gs          , Gs^Em       , Gs^Fmw      , Hh^Fp       , Wwg         , Mm^Xm       
_off^_usr          , _off^_usr          , _off^_usr          , _off^_usr          , _off^_usr          , _off^_usr          , _off^_usr          , _off^_usr          , Mm^Xm       , Mm^Xm       , Mm^Xm       , Mm^Xm       , Mm^Xm       , Mm^Xm       , Wog         , Mm^Xm       , Mm^Xm       , Mm^Xm       , Rb          , Mm^Xm       , Mm^Xm       , Mm^Xm       , Mm^Xm       , Mm^Xm       , Mm^Xm       , Mm^Xm       , Mm^Xm       , Mm^Xm       , Mm^Xm       , Mm^Xm       , Mm^Xm       , Mm^Xm       , Mm^Xm       , Wwg         , Wwg         
