border_size=1
usage=map

Wo, Wo, Ww, Ww, Ww, Ww, Ww, Ww, Ww, Ww, Gg^Fds, Ww, Ww, Ww, Ww, Ww, Ww, Ww, Ww, Wog, Ww, Wo, Wog, Wog, Wo, Ww, Wo, Wog, Wog, Wog, Wog, Wog, Wog, Wog, Wwg, Wwg, Wwg, Wwg, Wwg, Wwg, Wwg, Wog, Wog, Wog, Wog, Wog
Wo, Wo, Ww, Ww, Ww, Ww, Ss, Ww, Gg, Hh, Gg^Fds, Gg^Fds, Ss^Tf, Ww, Sm, Hh^Fds, Gg, Ww, Ww, Ww, Ww, Wog, Wo, Wo, Wo, Ww, Ww, Wog, Wog, Wog, Wog, Wog, Wog, Wwg, Wwg, Wwg, Aa, Wwg, Aa, Wwg, Ai, Wwg, Wwg, Wog, Wog, Wog
Ww, Ww, Gg, Ss, Ss, Hh^Fms, Gg, Ss^Bs/, Ss, Sm, Sm, Hh^Fms, Ss, Ss, Ss, Hh^Fms, Gg^Fds, Hh, Ww, Ww, Ww, Ww, Wo, Ww, Wo, Ww, Wog, Wog, Ww, Wog, Ha^Fpa, Ms, Ai, Wwg, Ai, Ha, Ha^Fma, Ha, Ms^Xm, Aa, Ha, Ha^Fpa, Ai, Wwg, Wwg, Wog
Ww, Ww, Gg^Fms, Ss^Fds, Ss^Tf, Sm, Gg^Fms, Gg^Fds, Hh^Fds, Ss^Tf, Ss, Ss, Ww, Ss^Fds, Ss, Ww, Ww, Ww, Ww, Wo, Wo, Wo, Ww, Wog, Wo, Wo, Wog, Ww, Wog, Wog, Ha, Aa, Wog, Wog, Wog, Ai, Aa, Ms, Ms, Ms, Aa, Ha, Ms, Ai, Wwg, Wog
Ww, Ww, Hh^Fms, Hh, Ss, Sm, Hh^Fms, Gg^Fds, Gg, Ss, Sm, Gg^Fds, Hh, Hh^Fms, Ww, Ww, Wo, Ww, Wog, Ww, Wo, Wog, Ww, Wo, Wo, Wog, Ww, Wog, Wog, Wog, Wog, Wog, Wog, Wog, Ai, Wwg, Wwg, Ha^Fda, Ha, Aa, Ha, Ha, Ha, Aa, Wwg, Wwg
Ww, Ww, Ww, Gg, Ww, Ss^Fds, Ss^Tf, Hh^Fms, Ss, Ss^Bs\, Gg, Gg, Ww, Ww, Xu, Xu, Xu, Xu, Xu, Xu, Xu, Xu, Xu, Xu, Xu, Xu, Xu, Wog, Wog, Wog, Xu, Wog, Wog, Wog, Wog, Ai, Wwg, Ai, Aa^Fma, Ha^Fpa, Ms, Aa, Ha^Fda, Ha^Fma, Wwg, Wwg
Ww, Ww, Ww, Ww^Bs|, Gg, Ss, Ww, Ww, Ww, Ww, Ww, Ww, Xu, Xu, Xv, Xv, Xv, Xv, Xv, Xv, Xv, Xv, Xv, Xv, Xv, Xu, Xu, Uh, Wog, Wog, Uu, Xu, Xu, Wog, Wog, Wog, Wog, Wwg, Ai, Aa^Fpa, Aa, Aa, Ai, Ai, Wwg, Wwg
Wo, Ww, Ww, Gg^Fds, Gg^Fms, Gg, Ww, Ww, Ww, Ww, Xu, Xu, Xv, Xv, Xv, Xv, Xv, Xv, Xv, Xv, Xv, Xv, Xv, Xv, Xv, Xu, Xu, Wwg^Xo, Wwg^Xo, Wwg^Xo, Wwg^Xo, Xu, Xv, Xu, Xu, Wog, Wog, Wog, Wog, Ai, Wog, Ai, Wwg, Wwg, Wwg, Wwg
Wo, Ww, Ww, Hh^Fms, Ww, Ww, Ww, Ww, Xu, Xu, Xv, Xv, Xv, Xv, Dd, Md, Hhd, Gd^Fts, Gd, Gs^Fet, Gs^Vo, Gg, Gg, Gd^Fts, Gd^Fts, Hhd, Xu, Wwf, Wwf, Wwf, Uu, Xu, Xv, Xv, Xv, Xu, Xu, Wog, Wog, Wog, Wog, Wog, Wog, Wog, Wog, Wog
Wo, Ww, Ww, Ww, Wo, Ww, Xu, Xu, Xv, Xv, Xv, Xv, Gd^Fts, Dd^Tf, Dd, Dd, Rd, Gd, Gs, Gs, Gs, Hh, Gg, Gg, Gg, Gd, Xu, Wwf, Wwf, Uu^Em, Xu, Xu, Gs, Xv, Xv, Xv, Xv, Xu, Xu, Wog, Wog, Wog, Wog, Wog, Wog, Wog
Wo, Ww, Ww, Wo, Xu, Xu, Xv, Xv, Xv, Xv, Dd, Hhd^Fts, Gd, Hd, Rd, Rd, Gs, Gs, Ss, Gg, Gg, Gg, Re, Rb, Ss^Tf, Gg, Gg, Xu, Wwf, Uh, Xu, Gg^Fet, Gg, Gg, Gg, Xv, Xv, Xv, Xv, Xu, Xu, Wog, Wog, Wog, Wog, Wog
Wo, Ww, Ww, Xu, Xv, Xv, Xv, Xv, Gs^Fet, Ch, Gs, Hh, Re, Rd, Rp^Vov, Gg, Gg, Mm, Gg^Fds, Gg, Gs, Rb, Rb^Fds, Hhd, Hhd, Ss, Rb, Gs, Wwf, Gg, Gs, Gs, Gg, Rp^Vov, Hh, Gg^Tf, Khs, Xv, Xv, Xv, Xv, Xu, Wog, Wog, Wog, Wog
Wo, Wo, Ww, Xu, Xv, Xv, Gg, 1 Kh, Ch, Ch, Wwf, Wwf, Wwf, Re, Gg, Gg, Gg^Tf, Gs, Gg, Gg, Wwf, Ss^Vhs, Rb, Md, Gs, Ss, Re, Gg, Gg^Fds, Wwf, Wwf, Gg, Gg, Gg, Gg^Fet, Gg, Chs, Chs, Chs, Xv, Xv, Xu, Wog, Wog, Wog, Wog
Wo, Wo, Wo, Xu, Xv, Xv, Gg, Gg^Fet, Ch, Kh, Wwf, Gg, Gg, Wwf, Wwf, Hh, Hh^Fp, Gg, Wwf, Wwf, Hh, Wwf, Wwf, Wwf, Wwf, Gs, Re, Gd^Tf, Mm, Hh, Re, Ww, Ww, Gg, Gg^Fds, Wwf, Gg, Gg, Chr, Xv, Xv, Xu, Wog, Wog, Wog, Wog
Ww, Wo, Wo, Xu, Xv, Xv, Gs, Ch, Gg, Gg, Wwf, Gg^Fds, Rd, Gg, Gg, Wwf, Wwf, Wwf, Gg, Gg, Gs^Tf, Wwf, Wwf, Gg^Fms, Re, Wwf, Wwf, Re, Re, Re, Rb, Ww^Bw\, Ww^Bw\, Wwf, Wwf, Wwf, Gs^Tf, Gg, Gs, Xv, Xv, Xu, Wog, Wog, Wog, Wog
Wo, Wo, Ww, Xu, Xv, Xv, Rb, Re, Gg, Hh, Wwf, Gg, Gs, Gs, Gg, Gg, Wwf, Gg, Gs, Md^Xm, Gs, Gg, Gg, Re, Gs, Hhd, Gs, Wwf, Ww, Ww, Ww, Ww^Vm, Ww, Re, Re, Gg, Rp^Vov, Gg, Re, Xv, Xv, Xu, Wog, Wog, Wog, Wog
Wo, Wo, Wo, Xu, Xu, Xu, Xu, Re, Wwf, Wwf, Hhd^Fds, Wwf, Gs^Vc, Gs, Gg, Wwf, Gg^Tf, Rp^Vov, Re, Md^Xm, Gg^Fp, Gg, Wwr, Re, Gg, Gd, Gd, Md^Xm, Md^Xm, Hh^Tf, Ww, Gg, Gg, Wwf, Gs, Re, Gs, Gg^Fms, Xu, Xv, Xu, Xu, Wo, Wog, Wog, Wog
Wot, Wo, Wo, Uh, Wwg, Wwg^Xo, Wwf, Wwf, Md, Hhd, Rd, Wwf, Gg, Gg^Fds, Gg, Wwf, Gg, Gs, Mm, Mm, Gg, Gg, Gg, Hh^Fds, Gg, Gs, Gs, Gs^Fms, Md^Xm, Wwr, Gs, Gs, Gg, Wwf, Gs, Re, Re, Gs, Uh, Xu, Wog, Xu, Wog, Wog, Wog, Wo
Wot, Wo, Wo, Wwg, Wwg, Wwg^Xo, Uh, Re, Re, Rd^Tf, Gs, Wwf, Gg, Hh, Gs, Wwf, Md^Xm, Mm, Gs, Gg, Gg, Gd^Tf, Gg, Gd^Tf, Gg, Gg, Mm, Mm, Gg, Wwf, Gg, Hh, Gg, Wwf, Rd, Rd^Tf, Md, Re, Wwf, Wwg^Xo, Wog, Wog, Wog, Wog, Wog, Wo
Wo, Wot, Ww, Xu, Xu, Xu, Xu, Gs, Gs, Re, Gs, Wwf, Gg, Gs, Ww, Wwr, Md^Xm, Gs^Fms, Gd, Gs, Gg, Hh^Fds, Wwr, Gg, Gg^Fp, Mm, Re, Gs, Gg^Tf, Wwf, Gg, Gg^Fds, Gs^Vc, Wwf, Hhd^Fds, Hhd, Wwf, Wwf, Xu, Wwg^Xo, Xu, Uh, Wo, Wo, Wo, Wog
Wot, Wot, Wo, Xu, Xv, Xv, Re, Gg^Fms, Rp^Vov, Re, Re, Wwf, Ww, Gg, Ww, Hh^Tf, Ww, Md^Xm, Gs, Gd, Gs, Re, Gg, Gg, Gs, Md^Xm, Gs, Rp^Vov, Wwf, Wwf, Gg, Gs, Gs, Wwf, Wwf, Wwf, Gg, Re, Rb, Xu, Xv, Xu, Wog, Wo, Ww, Wog
Wot, Wot, Wot, Xu, Xv, Xv, Gs, Gg, Gs^Tf, Gg, Wwf, Re, Ww^Bw\, Ww^Vm, Rb, Ww, Re, Wwf, Wwf, Hhd, Re, Re, Wwf, Gg, Gs^Tf, Md^Xm, Gg, Gg, Wwf, Gg, Gg, Gs, Rd, Gg, Wwf, Hh, Gg, Re, Gs, Xv, Xv, Xu, Wo, Wo, Wog, Ww
Wwt, Wot, Wot, Xu, Xv, Xv, Chr, Gg, Gg, Wwf, Gg^Fds, Wwf, Ww, Ww^Bw\, Re, Re, Mm, Re, Re, Wwf, Wwf, Gg^Fms, Wwf, Wwf, Hh, Gg, Wwf, Wwf, Hh^Fp, Wwf, Wwf, Gg, Gg, Gg^Fds, Wwf, Gg, Ch, Ch, Gg, Xv, Xv, Xu, Ww, Wo, Wo, Wo
Wwt, Wot, Wot, Xu, Xv, Xv, Chs, Gg, Chs, Wwf, Gg^Fet, Gg, Gg, Ww, Wwf, Hh, Gg^Fds, Gd^Tf, Re, Gs, Gs, Wwf, Rb, Wwf, Wwf, Wwf, Gg, Gg, Gg^Tf, Hh, Gg, Wwf, Wwf, Gg, Wwf, Kh, Ch, Gg^Fet, Gg, Xv, Xv, Xu, Wo, Wo, Ww, Wo
Wwt, Wwt, Wot, Xu, Xv, Xv, Xv, Chs, Khs, Gg, Hh, Gg, Gg, Gg, Gs, Wwf, Wwf, Gg, Rb, Ss, Hhd, Md, Rb^Fds, Ss^Vhs, Gg, Gg, Gg^Fds, Gs, Gg, Gg, Rp^Vov, Re, Re, Wwf, Gs, Ch, Gs^Fet, 2 Kh, Xv, Xv, Xv, Xu, Wo, Ww, Ww, Ww
Wwt, Wwt, Wot, Xu, Xu, Xv, Xv, Xv, Xv, Gg^Tf, Gg, Rp^Vov, Gg, Gs, Xu, Gg, Wwf, Gs, Gg, Ss, Ss^Tf, Hhd, Re, Rb, Gg, Gg, Ss, Mm, Gs, Gg, Rd, Rd, Rd, Hh, Dd, Ch, Xv, Xv, Xv, Xv, Xu, Xu, Ww, Ww, Ww, Ww
Wwt, Wwt, Wwt, Wot, Wwt, Xu, Xu, Xv, Xv, Xv, Xv, Gg, Gs, Gg^Fet, Xu, Uh, Wwf, Xu, Xu, Gg, Gg, Rb, Gg, Gg, Gs, Gg, Gs, Gs, Rd, Rd, Dd, Hd, Gd^Fts, Hhd^Fts, Xv, Xv, Xv, Xv, Xu, Xu, Wo, Ww, Ww, Ww, Ww, Ww
Wwt, Wwt, Wwt, Wwt, Wwt, Wot, Wot, Xu, Xu, Xv, Xv, Xv, Xv, Xu, Uu, Uu^Em, Wwf, Wwf, Xu, Gd, Gd^Fts, Gg, Gg, Hh, Gs^Vo, Gs, Gd, Gd, Hhd, Dd, Dd, Dd^Tf, Xv, Xv, Xv, Xv, Xu, Xu, Ww, Wo, Ww, Ww, Rp^Dr, Gs, Ww, Ww
Wwt, Wwt, Gs^Ft, Wwrt, Wwt, Wot, Wwt, Wot, Wot, Xu, Xu, Xv, Xv, Xu, Wwg^Xo, Wwf, Wwg^Xo, Wwf, Xu, Hhd, Xv, Gd^Fts, Xv, Gg, Xv, Gs^Fet, Xv, Gd^Fts, Xv, Md, Xv, Xv, Xv, Xv, Xu, Xu, Ww, Ww, Ww, Ww, Ww, Ww, Ww, Rr, Ww, Ww
Wwt, Wwt, Gs, Re^Ftr, Wwt, Wwt, Gs, Wwt, Wwt, Wwt, Wwt, Xu, Xu, Xu, Uu, Wwg^Xo, Wwg, Wwg^Xo, Xu, Xu, Xv, Xv, Xv, Xv, Xv, Xv, Xv, Xv, Xv, Xv, Xv, Xv, Xu, Xu, Ww, Ww, Ww, Gs^Fds, Rb, Ww, Rrc, Rrc, Rrc, Ww^Bsb|, Ww, Ww
Wwrt, Wwt, Wwt, Wwt, Gs^Ftr, Wwt, Wwt, Re^Ft, Wwt, Wwt, Wwt, Wot, Wot, Xu, Xu, Wwg, Wwg, Uh, Xu, Xu, Xu, Xv, Xu, Xv, Xu, Xv, Xu, Xv, Xu, Xv, Xu, Xu, Wo, Ww, Ww, Ww, Ww, Ww, Ww, Ww, Ww^Bsb/, Rrc, Rp, Rr, Gs^Dr, Ww
Wwt, Wwt, Md, Mv, Md, Gs, Gs^Ftr, Wwt, Wwrt, Hh^Ft, Gs^Ft, Wwt, Wwt, Wot, Wwt, Wwg, Wot, Wwg, Wwt, Xu, Wo, Xu, Wot, Xu, Ww, Xu, Wo, Xu, Wo, Xu, Wo, Wo, Ww, Ww, Rb^Dr, Rb^Fds, Rr, Rrc, Rrc, Ww^Bsb/, Ww, Ww, Rp, Rp, Gs, Ww
Wwt, Wwt, Hhd^Ftr, Md, Re, Hhd, Gs, Wwt, Gs, Mm, Gs, Wwt, Wwrt, Wwt, Wot, Wot, Wot, Wot, Wot, Wot, Wo, Ww, Ww, Wo, Wo, Wo, Wo, Wo, Wo, Wo, Ww, Ww, Ww, Ww, Gs^Fds, Rp, Re, Rb^Fds, Rb, Rrc, Gs, Ww, Ww, Rb^Fet, Ww, Ww
Wot, Wwt, Wwt, Re^Ftr, Wwt, Gs^Ft, Wwt, Wwt, Wwt, Wwt, Wwt, Wwt, Wwt, Wwt, Wwt, Wot, Wwt, Wo, Wo, Wot, Ww, Wo, Wot, Wot, Ww, Ww, Ww, Ww, Ww, Ww, Ww, Ww, Gs, Ww, Ww, Gs^Fet, Ww, Ww, Ww, Rp, Ww, Ww, Ww, Ww, Wo, Wo
Wog, Wot, Wwt, Wwt, Wwt, Wwt, Wwt, Wwt, Wwt, Wwt, Wwt, Wwt, Wwt, Wwrt, Wwt, Wot, Wot, Wot, Wot, Wo, Wo, Wo, Wo, Wo, Wo, Ww, Wo, Ww, Ww, Ww, Ww, Gs^Fet, Gs, Re, Rb, Ww, Wo, Ww, Ww, Ww, Ww, Ww, Ww, Wo, Wo, Wo
