Hhd^Fmf, Md, Hhd^Fmf, Md, Md, Md, Md, Md, Hhd^Fmw, Md, Md, Md, Md, Md, Md, Md, Md, Hh^Fds, Hh^Fms, Gg^Xo, Gg, Gg, Gg, Gg, Gg, Gg, Mm^Xm, Gg, Gg, Gg, Gg, Gg, Gg, Gg^Xo, Hh, Hh, Hh, Md, Md, Mm, Hh^Fms, Mm, Ms^Xm, Mm, Mm, Mm, Hhd^Fdw, Mm, Mm, Hhd^Fdw, Ms^Xm, Mm
Md, Md, Md, Md, Hh^Fms, Md, Md, Md, Mm^Xm, Md, Md, Md, Md, Md, Md, Md, Hh, Hh^Fds, Gg^Xo, Gg^Xo, Gg, Gg, Gg, Gg, Gg, Md, Mm^Xm, Md, Gg, Gg, Gg, Gg, Gg, Gg^Xo, Gg^Xo, Gg, Hh^Fp, Hh^Fp, Md, Mm, Mm, Ms^Xm, Ms^Xm, Ms^Xm, Mm, Mm, Qlf, Mm, Ms^Xm, Mm, Ms^Xm, Mm
Md, Md, Md, Ms^Xm, Md, Mm^Xm, Mm^Xm, Mm^Xm, Md, Md, Md, Md, Hh^Fp, Md, Hh, Hh^Fds, Gg^Xo, Gg^Xo, Gg, Gg, Gg, Gg, Gg, Gg, Gg, Md, Mm^Xm, Md, Gg, Gg, Gg, Gg, Gg, Gg, Gg^Xo, Hh, Hh, Hh^Fp, Hh^Fms, Md, Md, Md, Md, Mm, Mm, Qlf, Mv, Ql, Mm, Ms^Xm, Mm, Mm
Hh^Fms, Hh^Fp, Md, Md^Xm, Md, Md, Md, Mm^Xm, Md, Md, Md, Md, Hh, Hh, Hh^Fp, Hh, Gg^Xo, Gg, Gg, Gg, Gg, Gg, Gg, Chr, Gg, Gg, Gg, Gg, Gg, Ce^Em, Gg, Gg, Hh^Fp, Gg, Gg, Gg^Xo, Gg^Xo, Hh^Fms, Gg^Xo, Hh, Hh^Fds, Hh^Fp, Hh, Md, Md, Mm, Mm, Mm, Mm, Mm, Hhd^Fmw, Mm
Md, Md, Md, Mm^Xm, Md, Md, Md, Md, Md, Md, Hh, Hh^Fp, Hh, Hh^Fms, Hh, Hh, Gg^Xo, Gg, Gg, Gg, Gg, Gg, Gg, Gg, Gg, Gg, Gg, Gg, Gg, Gg, Gg, Gll^Fp, Gg, Gg, Gg, Gg, Gd^Fetd, Gg^Xo, Gg, Gg^Xo, Gg^Xo, Hh, Hh, Hh^Fds, Hh^Fds, Md, Md, Md, Md, Mm, Mm, Mm
Md, Md, Md, Md, Md, Md, Md, Md, Hh, Hh, Gg, Gg, Gg^Xo, Gg^Xo, Gg^Xo, Gg^Xo, Gg, Gg, Gg, Gg, Gg^Fet, Gg, Gg, Chr^Em, Gg, Gg, Gg, Gg, Gg, Ce, Gg, Gg, Gg, Gg, Gg^Es, Gg, Gg, Gg, Gg, Gg, Gg, Gg^Xo, Gg^Xo, Hh, Hh^Fp, Hh^Fp, Md, Md, Md, Md, Md, Mm
Md, Md, Hh^Fp, Hh^Fp, Md, Md, Hh^Fp, Hh^Fms, Hh, Hh, Gg^Xo, Gg^Xo, Mm, Gg, Gg, Gg, Gg, Gg, Gg, Gg, Gg, Gg, Gg, Gg, Gg, Gg, Mm^Xm, Gg, Gg, Gg, Gg, Gg, Gg, Gg, Gg, Gg, Gg, Gg, Gg, Gg, Gg, Gg, Gg, Gg^Xo, Gg^Xo, Hh, Hh, Hh, Md, Hh^Fms, Md, Md
Md, Md, Md, Hh^Fds, Hh, Hh, Gg, Hh, Gg^Xo, Gg^Xo, Gg, Gg, Gg, Gg, Gg, Gg, Gg, Gg, Gg, Gg, Gs^Fds, Gg, Gg, Gg, Gg, Mm, Mm^Xm, Mm, Gg, Gg, Gg, Gg, Gd^Fetd, Gg, Gg, Gg, Hhd^Edp, Gg, Gg, Hhd^Fmw, Gg, Hhd^Edp, Hhd^Edp, Gg, Gg, Gg^Xo, Gg^Xo, Gg, Hh, Hh^Fms, Hh, Hh
Hh, Md, Hh^Fp, Hh, Hh, Hh, Gg^Xo, Gg^Xo, Gg, Gg, Gg, Gg, Gg, Gg, Gg, Gg, Gg, Gg, Gg, Hh^Fds, Gll^Fmf, Gg, Gg, Gg, Gg, Mm, Mm^Xm, Mm, Gg, Gg, Gg, Gg, Gg, Gg, Gg, Hhd^Edp, Hhd^Edpp, Gg, Gg, Gg, Gg, Gg, Hhd^Edp, Gg, Gg, Gg, Hh, Gg^Xo, Gg^Xo, Hh, Gg^Xo, Hh
Gg^Xo, Hh, Hh, Hh, Gg^Xo, Gg^Xo, Gg^Eff, Gg^Eff, Gg^Eff, Gg, Gg, Gg, Gg, Hh^Fms, Gs^Fdw, Gg, Gg, Gg, Gg, Gg, Gg, Gg, Gg, Chr, Gg, Gg, Gg, Gg, Gg, Ce^Em, Gg, Gg, Gg, Gg, Gg, Gg, Gg, Gg, Gg, Gg^Es, Gg, Gg, Gg, Gg, Gg, Hh, Hh^Fds, Hh^Fp, Hh, Gg^Xo, Gg, Gg^Xo
Gg, Gg^Xo, Gg^Xo, Gg^Xo, Gg^Eff, Gg^Eff, Gg^Gvs, Gg^Gvs, Gg^Gvs, Gg^Eff, Gg^Eff, Gg, Gd^Fmw, Hh^Fp, Gg, Gg, Gg, Gg, Gg, Gg^Es, Gg, Gg, Gg, Gg, Gg, Gg, Gg, Gg, Gg, Gg, Gg, Gs^Fdw, Hhd^Fdw, Hhd^Fdf, Gg, Gg, Gg, Gg, Gg, Gg, Gg, Gg, Hhd^Fdw, Gg, Gg, Hh^Edp, Gg, Gg, Gg, Gg, Hhd, Gg
Gg, Gg, Gg^Eff, Gg^Eff, Gg^Gvs, Gg^Gvs, Gg^Gvs, Gg^Gvs, Gg^Eff, Gg^Eff, Gg, Gg, Gg, Gg, Gg, Gg, Gg, Rr^Vhc, Gg, Gg, Gg, Gg, Gg, Chr^Emf, Gg, Gg, Gg, Gg, Gg, Ce, Gg, Gg, Gg, Gg, Gg, Gd^Vo, Gg, Gg, Gg^Es, Gg, Gg, Gg, Gg, Hhd^Fdw, Gg, Gg, Gg, Gd^Fetd, Gg, Hhd^Fmw, Hhd, Gg
Gg^Eff, Gg^Eff, Gg^Gvs, Gg^Gvs, Gg^Gvs, Gg^Gvs, Gg^Eff, Gg^Eff, Gg, Gg, Gg, Gg, Gg, Gg, Gg, Gg, Gg, Gg, Chr, Gg, Gg, Gg, Gg, Gg, Gg^Es, Gg, Mm^Xm, Gg, Gg, Gg, Gg, Gg, Gg, Gg, Co, Gg, Gg, Gg, Gg, Gg, Gg, Gg, Gg, Gg, Gg, Gg^Es, Gg, Gg, Hhd^Edpp, Hhd^Edpp, Gg, Gg
Gg^Gvs, Gg^Gvs, Gg^Gvs, Gg^Gvs, Gg, Gg, Gg, Gg, Gg, Gg, Gg, Gg, Gg, Gg, Gg, Gg, Gg, Khr, Gg, Gg, Gg, Gg, Gg^Fet, Gg, Gg, Mm, Mm^Xm, Mm, Gg, Gg, Gd^Fetd, Gg, Gg, Gg, Gg, Ko, Gg, Gg, Hh, Hh^Edpp, Hh^Edpp, Gg, Gg, Gg, Gg, Gg, Gg, Gg, Gg, Gg, Hhd^Fmw, Gg
Gg^Gvs, Gg^Gvs, Gg^Eff, Gg^Eff, Gg, Gg, Hh^Fds, Gg, Ch, Gg, Gg, Gg, Gg, Gg, Gg, Gg, Gg, Chr, Gg, Gg, Gg, Gg, Gg, Gg, Gg, Mm, Mm^Xm, Mm, Gg, Gg, Gg, Gg, Hhd^Fdw, Gg, Gg, Co, Gg, Gg, Gg, Gg, Gg, Gg, Gg, Gg, Co, Gg, Hh^Fds, Gg, Gg, Gg, Gg, Gg
Gg^Eff, Gg^Eff, Gg, Gg^Wm, Gg, Gg, Ch, Ch, Gg, Kh, Gg, Gg, Rr^Vhc, Gg, Gg, Gg, Gg, Gg, Gg, Gll^Fp, Gg, Gg, Gs^Fds, Gg, Gg, Hh, Hh^Fds, Hh, Gg, Gg, Gg, Gg, Gg, Gg, Gg, Gg, Gg, Gg, Gg, Gg, Gd^Vo, Gg, Gg, Ko, Gg, Co, Co, Gg, Gg, Gg, Gg, Gg
Gg, Gg, Gg^Eff, Gg, Gg, Ch, Gg, 2 Kh, Gg, Gg, Gg, Gg, Gg, Gg, Gg, Gg, Gg^Es, Gg, Gg, Gg, Gg, Gg, Gg, Gg, Gg, Hh, Hh^Fds, Hh, Gg, Gg, Gg, Gg, Gg, Gg, Gg, Hh, Hh, Gg, Gg, Gg, Gg, Gg, Gg, Gg, Gg, 3 Ko, Gg, Co, Gg, Gg, Gg, Gg
Gg^Eff, Gg^Eff, Gg^Gvs, Gg^Eff, Gg^Eff, Kh, Gg, Gg, Gg, Wo, Wo, Gg, Chr, Gg, Gg, Gg, Gg, Gg, Gs^Vl, Gg, Gg, Dd^Do, Ww, Gg, Ww^Bw|, Hh, Ww^Vm, Hh, Ww, Dd^Do, Ww, Gg, Gg, Gg, Gd^Vo, Gg, Gg, Gg, Gg, Gg, Khs, Gg, Wo, Wo, Gg, Gg, Gg, Ko, Gg, Gg, Gg, Gg
Gg^Gvs, Gg^Gvs, Gg^Gvs, Gg^Gvs, Gg^Gvs, Gg, Gg^Eff, Gg, Gg, Gg, Chr, Wo^Bw/, Wo, Gg, Gg, Gg, Gg, Gg, Gg, Gg, Ww, Wwf, Wwf, Ww, Ww^Bw|, Ww, Kud, Ww, Ww, Ww, Wwf, Wwf, Ww, Gg, Gg, Gg, Gg, Gg, Gg, Gg, Wo, Wo^Bw\, Khs, Gg, Gg, Gg, Gg, Gg, Gg, Gg, Gg, Gg
Gg^Gvs, Gg^Gvs, Gg^Gvs, Gg^Gvs, Gg^Gvs, Gg^Gvs, Gg^Eff, Gg^Eff, Gg, Gg, Gg, Gg, Gg, Wo, Wo, Gg, Chr, Gg, Gg, Ww, Ww, Wwf, Wwf, Ww, Gg, Hh^Fds, Kud, Hh^Fms, Gg, Ww, Wwf, Wwf, Ww, Ww, Gg, Gg, Khs, Gg, Wo, Wo, Gg, Gg, Gg, Gg, Gg, Gg, Gg, Gg, Hh^Fp, Hh^Edp, Gg, Gg
Gg^Gvs, Gg^Gvs, Gg^Gvs, Gg^Gvs, Gg^Eff, Gg^Eff, Gg, Gg, Gg, Gg, Gg, Gll^Fp, Gg, Gg, Chr, Wo^Bw/, Wo, Gg, Ww, Ww, Sm, Sm, Ww^Ewf, Wwf, Gg, Hh^Fms, Ww, Hh^Fds, Gg, Ww^Ewf, Wwf, Ww, Ww^Bw/, Ww^Bw/, Ww, Gg, Wo, Wo^Bw\, Khs, Gg, Gg, Gg, Gg, Gg, Gg, Gg, Gg, Gg, Hh^Edp, Hh^Edp, Gg, Gg
Gg, Gg^Gvs, Gs^Fms, Gg^Eff, Gg, Gg, Gg, Rr^Vhc, Gg, Gg, Gg, Gg, Gg, Gg, Gg, Gg, Gg, Wo, Ss^Vhs, Sm, Hh^Fp, Gg, Gg, Wwf^Bw/, Ww^Ewl, Wwrt, Gg, Wwrg, Wwf, Wwf^Bw\, Gg, Gg, Hh^Fds, Ww, Ss^Vhs, Wo, Gg, Gg, Gg, Gg, Gg, Gg, Hh, Gg, Gg, Gd^Vo, Gg, Gg, Gg, Gg, Gg, Gg
Gg^Eff, Gg^Eff, Gg, Hh^Fp, Gg, Gg, Gg, Gg, Gg, Gg, Gg, Gg, Gg, Gs^Vl, Gg, Gg, Gg, Ww, Ww, Khs, Khs, Hh^Fms, Wwrg, Wwf, Ss, Gg, Wog^Bsb|, Gg, Ss, Ww^Ewl, Wwrt, Hh^Fms, Ko, Ko, Sm, Ww, Dd^Do, Gg, Gg, Gd^Vo, Gg, Gg, Hh^Fms, Hh, Gg, Gg, Gg, Gg, Gg, Gg, Gg, Gg
Gg, Gg, Gg, Gg, Gg, Gg, Gg, Gg, Gg^Es, Gg, Gg, Gg, Gg, Gg, Gg, Gg, Ww, Ww^Bw\, Ww^Bw\, Hh^Fds, Hh^Fms, Ww, Gg, Gg, Wog, Ww^Ewl, Wog^Bsb|, Ww^Ewf, Wog, Gg, Gg, Ww, Hh^Fms, Hh^Fp, Sm, Ww, Ww, Gg, Gg, Gg, Gg, Gg, Gg, Gg, Gg, Gg, Gg, Gg, Hhd^Fmw, Gg, Gg, Gg
Gg, Gg, Gg, Gg, Gg, Gg, Gg, Gg, Gg, Gg, Gg, Gg, Gg, Hh^Fms, Gg, Gg, Ww, Ww, Ww, Gg, Gg, Wwrt, Gg, Wwf, Wwf, Chw, Ha^Fpa, Chw, Wwf, Wwf, Gg, Wwrg, Gg, Gg, Sm, Ww, Ww, Gg, Gg, Gg, Gs^Fms, Gg, Gg, Gg, Gg, Gg, Gg, Gg, Gg, Gg, Gg, Gg
Gg, Gg, Gg^Es, Gg, Gg, Rr^Vhc, Gg, Gg, Chr, Gg, Gg, Gg, Gg, Gg, Gg, Dd^Do, Wwf, Wwf, Wwf, Wwf, Wwf^Bw|, Ww^Ewl, Ss, Wog, Chw, Aa^Fpa, Aa^Vaa, Ha, Chw, Wog, Ss, Wwf, Wwf^Bw|, Ww^Ewf, Wwf, Wwf, Wwf, Gg, Gg, Hh^Fp, Gg, Gg, Gg, Co, Ko, Gg, Gg, Gd^Vo, Gg, Gg, Gg, Gg
Gg, Gg, Gg, Gg, Gg, Gg, Chr, Khr, Gg, Gg, Gg, Gg, Gg, Gg, Gg, Gg, Ww, Wwf, Ww, Ww^Ewf, Gg, Wwf, Gg, Ww^Ewf, Wog^Bsb/, Ha, Ha^Fda, Ha^Fma, Wog^Bsb\, Ww^Ewl, Gg, Ww^Ewl, Gg, Wwf, Ww, Wwf, Ww, Gg, Gg, Gg, Gg, Gg, Gg, Gg, Gg, Co, Gg, Gg, Gg, Gg, Gg, Gg
Gg, Gg, Gg, Gg, Gg, Gg, Gg, Gg, Gg, Gg, Gs^Fms, Gg^Es, Gg, Gg, Gll^Fp, Gg, Gg, Ww, Ww, Gg, Hh^Fms, Wwrg, Gg, Wog^Bsb/, Ww^Ewl, Chw, Wwf, Chw, Ww^Ewf, Wog^Bsb\, Gg, Wwrt, Hh^Fms, Gg, Ww^Bw\, Ww, Gg, Gg, Gg, Gg, Uu^Tf, Gg, Gg, Gg, Gg, Gg, Gg, Gg, Gg, Gg, Gg, Gg
Gg, Gg, Gg, Gg, Gg, Gg, Gg, Gg, Gg, Gll^Fp, Gg, Gg, Gg, Gg, Gg, Gg, Gg, Ww, Ww, Hh^Fds, Kdr, Ww, Wwrt, Gg, Ss, Wog, Wwf, Wog, Ss, Gg, Wwrg, Ww, Ke, Hh^Fds, Ww, Ww^Bw\, Gg, Gg, Gg, Gd^Fetd, Gg, Gg, Gg, Hhd^Fmw, Hhd^Fdw, Gg, Gg, Gg, Gg, Gg, Gg, Gg
Gg, Gg, Gg, Gg, Gg, Gg, Gg, Gg, Gg, Gg, Gg, Gg, Gg, Gg, Gg, Gg, Hh, Hh, Ww^Vm, Kdr, Hh^Fms, Hh^Fds, Gg, Ww^Ewl, Wwf, Gg, Gg, Gg, Ww^Ewl, Wwf, Gg, Hh^Fds, Hh^Fms, Ke, Ww^Vm, Hh, Hh, Gg^Emf, Gg, Gg, Gg, Gg, Gg, Gg, Gg, Gg, Gg, Gg, Uu^Tf, Gg, Gg, Gg
Gg, Gg, Gg, Gg, Gg, Gg, Gg, Gg, Gg, Gg, Chr^Emf, Gg, Gg, Gg, Mm, Hh, Hh^Fds, Hh^Fds, Ww, Ww, Ww^Bw/, Gg, Wwf, Wwf^Bw\, Gg, Wwrg, Ww, Wwrt, Gg, Wwf^Bw/, Ww^Ewf, Gg, Ww, Ww, Ww, Hh^Fds, Hh^Fds, Hh, Mm, Gg, Gg, Ce^Em, Gg, Gg, Gg, Hhd, Hhd, Gg, Gd^Fetd, Gg, Gg, Gg
Gg, Gg, Gg, Gll^Fp, Hh^Fds, Gg, Gg, Gg, Chr, Gg, Gg, Gg, Gg, Mm, Mm^Xm, Mm^Xm, Hh, Hh, Gg, Ww^Bw/, Ww, Ww, Wwf, Ww^Ewf, Gg, Hh^Fds, Kv, Hh^Fp, Gg, Wwf, Wwf, Ww, Ww, Ww, Dd^Do, Hh, Hh, Mm^Xm, Mm^Xm, Mm, Gg, Gg, Gg, Ce, Gg, Hhd, Gg, Gg, Gg, Gg, Gg, Gg
Gg, Gg, Gg, Gg, Gg, Gg, Gg, Gg, Gg, Gg, Gg, Gg, Gg, Mm^Xm, Mm, Mm, Gg, Gg, Gg, Ww, Ww, Wwf, Wwf, Ww, Sm, Hh^Fms, Kv, Hh^Fms, Sm^Bw|, Ww, Wwf, Wwf, Ww, Ww, Gg, Gg, Gg, Mm, Mm, Mm^Xm, Gg, Gg, Gg, Gg, Gg, Gg, Gg, Gg, Gg, Gg, Gg, Gg
Gg, Gg, Gg, Gg, Chr^Em, Gg, Gg, Gg, Mm, Gg, Gg, Gg, Gg^Efm, Gg, Gg, Gg, Gg, Gg, Gg, Gg^Esd, Gg^Esd, Wwf, Ww, Ww, Ww, Sm, Ss^Vhs, Sm, Ww^Bw|, Ww, Ww, Wwf, Gg, Gg, Gg, Gg, Gg, Gg, Gg, Gg, Gg, Gg, Gg, Gg, Mm, Gg, Gg, Ce, Gg, Gg, Gg, Gg
Gg, Gg, Chr, Gg, Gg, Gg, Gg, Mm, Mm^Xm, Mm^Xm, Gg, Gg, Gg, Gg, Cv, Gg, Gg, Gg, Gg, Gg, Gs^Ft, Gg, Gg, Dd^Do, Gg, Gg, Wo, Gg, Gg, Gg, Gg^Es, Gg, Gg, Gd^Fdf, Gg, Gg^Fet, Gg, Gg, Cv^Em, Gg, Gg, Gg^Efm, Gg, Mm^Xm, Mm^Xm, Mm, Gg, Gg, Gg, Ce^Em, Gg, Gg
Gg, Gg, Gg, Gg, Gg, Gg, Gg, Mm^Xm, Mm, Mm, Gg, Gg, Cv^Emf, Gg, Gg, Gg, Gg, Gg^Fet, Gg, Gs^Ft, Gs^Ft, Gg, Gs^Vc, Gg, Gg, Cv, Wo^Bw\, Gg, Gg, Gg, Gg, Gg, Gg, Gg^Efm, Gg, Gg, Gg, Gg, Gg^Es, Gg, Cv^Emf, Gg, Gg, Mm, Mm, Mm^Xm, Gg, Gg, Gg, Gg, Gg, Gg
Gg, Gg, Md, Gg, Gg, Gg^Efm, Gg, Gg, Gg, Gg, Gg, Gg, Gg, Gg, Gll^Fp, Gg^Efm, Gg, Gg, Gg, Gg, Gg, Gg, Gg, Gg, Gg, Gg, Wo, Cv, Gg, Gg, Gg, Gs^Vc, Gg, Gg, Gg, Hhd^Fdf, Gg, Gg, Gg^Es, Gg, Gg, Gg, Gg, Gg, Gg, Gg, Gg, Gg^Efm, Gg, Gg, Md, Gg
Gg, Md, Mm^Xm, Mm^Xm, Gg, Gg, Gg, Gg, Cv, Gg, Gg, Gg, Gg, Gg, Gg^Efm, Gll^Fp, Gg, Gg, Cv, Gg, Gg, Gg, Gg, Gg, Gg, Gg, Wo, Gg, Gg, Gg, Gg, Gg, Gg, Gg, Gg, Gg, Gg, Gg, Gg, Gg, Gg, Gg, Gg, Gg, Cv^Emf, Gg, Gg, Gg, Gg, Md^Xm, Md^Xm, Md
Gg^Xo, Mm^Xm, Md, Md, Gg, Gg, Cv^Em, Gg, Gg, Gg, Gg, Gg, Gg, Gg, Gg, Gg, Gg, Gg, Kv, Gg, Gg, Hh^Fp, Gg, Gg, Gg, Gg, Wo, Gg, Gg, Gg, Gg^Fet, Gg, Gg, Cv, Kv, Gg, Gg, Gg, Gg, Gll^Fp, Gg, Gg, Gg, Gg, Gg, Gg, Cv, Gg, Gg, Md, Md, Md^Xm
Gg, Gg^Xo, Gg^Xo, Gg, Gg, Gg, Gg, Gg, Gg, Gg, Gg, Hh^Fp, Hh^Fp, Gg, Gg, Gg, Gg, Cv, Gg, Gg, Gg, Gll^Fp, Gg, Gg, Gg, Gg, Wo, Gg, Gg, Gg, Gg, Gg, Gg, Gg, Gg, Cv, Gg, Gg, Gg, Gs^Fms, Gg, Gg, Gg^Fet, Gg, Gg^Efm, Gg, Gg, Gg, Gg, Gg^Es, Gg, Gg
Hh, Gg, Hh^Fp, Gg^Xo, Gg^Xo, Gg, Gg, Gg, Gg, Gg, Gg^Efm, Gg, Gg, Gg, Gg, Gg^Ve, Gg, Gg, Gg, Gg, Gg, Gg, Gg^Efm, Gg, Gg, Cv, Wo^Bw\, Gg, Gg, Gg, Gg, Gg, Gg^Efm, Gg, Gg, Gg, Gg, Gg^Ve, Gg, Gg, Gg^Efm, Gg, Gg, Gg^Efm, Gg, Gg, Gg^Xo, Gg^Xo, Gg^Xo, Gg, Gg^Xo, Gg
Mm, Hh, Hh^Fms, Hh^Fms, Hh^Edpp, Gg^Xo, Gg^Xo, Gg, Gg, Hh^Fp, Gs^Fms, Gg, Gg, Gg, Gg, Gg, Gg, Gg, Gg, Gg, Gg, Gg, Gg^Ve, Gg, Gg, Gg, Wo, Cv, Gg, Gg, Gg, Gg, Gg, Gg, Gg, Gg, Gg, Gg, Gg, Gg, Gg, Gg, Gg, Gg, Gg^Xo, Gg^Xo, Gg, Gg, Hh^Fms, Gg^Xo, Hh^Edp, Gg^Xo
Mm, Mm, Mm, Hh^Edpp, Hh^Edpp, Hh^Fp, Hh^Edpp, Gg^Xo, Gg^Xo, Gs^Fms, Gs^Fdw, Gg, Gg, Gg, Gg, Gll^Fp, Hh^Fp, Gs^Fds, Gg, Gg, Gg^Efm, Gg, Gg, Gg, Gg, Gg, Wo, Gg, Gg, Gg, Gg, Gg^Ve, Gg, Gg, Gg, Gg, Gg, Gg, Gll^Fp, Gg, Gg, Gg, Gg, Gg^Xo, Gg, Hh^Fms, Hh^Edpp, Hh^Edpp, Hh, Hh, Hh^Fms, Hh
Mm, Mm, Mm, Mm, Mm, Hh^Edpp, Hh^Fp, Hh^Edpp, Gg^Xo, Gg, Gg, Gg, Gg, Gg, Gg, Gs^Fds, Gll^Fp, Gs^Fds, Gg, Gg, Gg^Efm, Gg, Gg, Gg, Gg, Gg, Gg, Gg, Gg, Gg, Gg, Gg, Gg, Gg, Gg, Gg, Gs^Fms, Hh^Fms, Gg, Gg, Gg, Gg, Gg^Xo, Gg^Xo, Hh^Fp, Hh^Edp, Hh^Fds, Hh, Mm, Mm, Mm, Mm
Mm, Mm, Mm, Mm, Mm, Mm, Mm, Hh^Fds, Hh, Gg^Xo, Gg^Xo, Gg, Gg, Gg, Gg, Gg, Gg, Gg, Gg, Gg, Gll^Fp, Gg, Gg, Kv, Cv, Gg, 1 Kv, Gg, Cv, Kv, Gg, Gg, Gg, Gg, Gg, Gs^Fds, Hh^Fp, Gd^Fmw, Gg, Gg, Gg^Xo, Gg^Xo, Hh, Hh, Mm, Mm, Mm, Mm, Mm, Mm, Mm, Mm
Mm, Mm, Mm, Mm, Mm, Mm, Mm, Hh^Fp, Hh, Hh^Fms, Hh^Fms, Gg^Xo, Gg, Gg, Gg, Gg, Gg, Gg, Gg, Gll^Fp, Gll^Fp, Gll^Fp, Gs^Fds, Gg, Gg, Cv, Hh^Fds, Cv, Gg, Gg, Gg, Gg, Gll^Fp, Gg, Gll^Fp, Gg, Gg, Gs^Fds, Gg, Gg^Xo, Hh, Hh, Hh, Hh^Fms, Mm, Mm, Mm, Mm, Mm, Mm, Mm, Mm
Mm, Mm, Mm, Mm, Mm, Mm, Mm, Mm, Mm, Hh^Fms, Hh^Fp, Gg^Xo, Gg, Gg, Gg, Gg, Gg, Gg, Gll^Fp, Hh^Fp, Hh^Fp, Gs^Fds, Gs^Fms, Gg, Gg, Gg, Gg, Gg, Gg, Gg, Gg, Gg, Gll^Fp, Gll^Fp, Hh^Fms, Gs^Fdw, Gs^Fds, Gg, Gg, Gg^Xo, Hh, Hh^Fp, Mm, Mm, Mm, Mm, Mm, Mm, Mm, Mm, Hh^Fms, Mm
