Mm^Xm       , Hh          , Hh^Tf       , Hh^Fp       , Hh^Fms      , Hh^Fms      , Mm^Xm       , Mm^Xm       , Hh^Fp       , Mm          , Ce          , Mm          , Mm          , Mm^Xm       , Hh^Fds      , Hh          , Hh^Tf       , Hh^Fp       , Mm^Xm       , Hh^Fp       , Wwg         , Wwg         , Mm^Xm       , Mm^Xm       , Mm^Xm       , _off^_usr          , _off^_usr          , _off^_usr          , _off^_usr          , _off^_usr          , _off^_usr          , _off^_usr          , _off^_usr          , _off^_usr          , _off^_usr          
Wwf         , Mm^Xm       , Gs          , Mm^Xm       , Gs^Efm      , Mm^Xm       , Ss          , Mm^Xm       , Ce          , Mm^Xm       , Ce          , Mm^Xm       , Hh          , Mm^Xm       , Ss          , Mm^Xm       , Gg^Efm      , Mm^Xm       , Gg          , Mm^Xm       , Wwf         , Mm^Xm       , Hh^Tf       , Mm^Xm       , Hh          , Mm^Xm       , Mm^Xm       , _off^_usr          , _off^_usr          , _off^_usr          , _off^_usr          , _off^_usr          , _off^_usr          , _off^_usr          , _off^_usr          
Hh          , Wwf         , Wwg         , Gs          , Gg          , Gg          , Gs^Fds      , Ss          , Ce          , Ce          , 2 Ke        , Wwf         , Gs          , Mm          , Gg          , Gg          , Gs          , Gg          , Gs          , Wwf         , Wwf         , Gg          , Gs          , Gs          , Gs          , Gg          , Gg          , Mm^Xm       , Mm^Xm       , _off^_usr          , _off^_usr          , _off^_usr          , _off^_usr          , _off^_usr          , _off^_usr          
Hh^Fms      , Hh          , Wwg         , Gll^Tf      , Gs          , Gs^Vhs      , Gs          , Gs          , Gg          , Ce          , Ce          , Wwf         , Gg          , Gg          , Gg          , Hh^Fp       , Gs^Fms      , Gg          , Gs^Efm      , Gs          , Wwf         , Gs^Fp       , Wwf         , Wwf         , Wwf         , Gs^Vl       , Gg          , Gs          , Gs          , Mm^Xm       , Mm^Xm       , _off^_usr          , _off^_usr          , _off^_usr          , _off^_usr          
Gs^Fds      , Gg          , Gs^Efm      , Wwg         , Wwf         , Gs          , Gg          , Gs          , Gg          , Gg          , Gg          , Wwf         , Wwg         , Gs          , Gs          , Hh^Vc       , Gg          , Gg          , Gg          , Ce          , Ke          , Wwf         , Wwg         , Wwg         , Wwg         , Wwf         , Wwf         , Gs^Efm      , Gg          , Gs^Fmw      , Mm          , Mm^Xm       , Mm^Xm       , _off^_usr          , _off^_usr          
Gs^Fms      , Gs          , Gs          , Gs          , Wwf         , Gs          , Gs^Fp       , Gg          , Gg          , Gg^Efm      , Gs          , Hh          , Gll^Tf      , Wwg         , Wwg         , Gg          , Gs          , Gg          , Ce          , Ce          , Wwg         , Wog         , Wog         , Wog         , Wog         , Wwg         , Wwf         , Gs          , Gg          , Gg          , Hh          , Hh^Fp       , Ss          , Mm^Xm       , Mm^Xm       
Wwg         , Gg          , Gll^Vhc     , Gs          , Gs          , Wwf         , Wwg         , Hh^Fms      , Gg          , Gs          , Gs          , Gs          , Gs          , Gg          , Gs^Efm      , Wwg         , Gg          , Gs          , Gs          , Hh^Fds      , Wwg         , Wwg         , Wog         , Wog         , Wog         , Wwg         , Wwf         , Gg          , Gg          , Gg          , Gs          , Gs          , Gs          , Ss          , Hh^Fdw      
Mm^Xm       , Hh          , Gs          , Gs          , Gg          , Gs^Fms      , Mm          , Wwg         , Gg          , Gg          , Gg          , Gg          , Gg          , Gg          , Hh          , Wwg         , Gg          , Gs          , Gg^Efm      , Wwf         , Wwf         , Wwg         , Wwg         , Wwg         , Wwf         , Wwf         , Hh          , Gs^Fds      , Gg          , Gs          , Gs          , Gg^Efm      , Gg          , Gg          , Mm          
Ss          , Ss          , Gg          , Gs          , Gg^Efm      , Hh^Fp       , Wwf         , Wwg         , Gs          , Gg          , Gs^Vd       , Gg          , Gg          , Hh^Fdw      , Mm^Xm       , Wwg         , Wwg         , Gg          , Gg          , Wwf         , Wwf         , Wwf         , Gs^Em       , Gs^Em       , Wwf         , Gs^Fdw      , Gs^Fmw      , Gg          , Gg          , Gs          , Gll^Tf      , Gg          , Gg          , Gg          , Hh^Fds      
Hh^Tf       , Ce          , Gg          , Gg          , Gg          , Gs          , Wwf         , Gs^Fds      , Gs          , Gs          , Gs^Fms      , Gg^Efm      , Gs          , Gll^Tf      , Mm^Xm       , Mm^Xm       , Wwf         , Gs^Em       , Gs          , Hh^Fp       , Mm^Xm       , Mm          , Gs          , Gs^Em       , Wwf         , Gg          , Gg          , Gs          , Gg          , Ss          , Gg          , Gs          , Gs          , Gs^Fp       , Wwf         
Ce          , Ce          , Ce          , Ce          , Gg          , Gg          , Gs          , Wwf         , Gs          , Ss          , Mm^Xm       , Gs          , Wwf         , Wwf         , Wwf         , Wwf         , Gs^Fmw      , Gs^Ve       , Gs          , Gs^Em       , Gs          , Gs^Fms      , Gs          , Gs          , Mm^Xm       , Wwf         , Wwf         , Gg          , Gs          , Gg          , Gg          , Gs          , Wwf         , Wwf         , Mm^Xm       
Ce          , 3 Ke        , Ce          , Gg          , Gs          , Gs^Fp       , Gs          , Wwg         , Gs          , Mm^Xm       , Mm          , Gs          , Wwf         , Hh          , Hh^Fms      , Gs          , Gs^Em       , Gs          , Gs          , Gs          , Hh          , Gs          , Gs          , Gs^Em       , Mm^Xm       , Hh^Fms      , Wwf         , Gs          , Gs          , Hh          , Mm          , Wwg         , Gg          , Gs          , Mm^Xm       
Wwf         , Wwf         , Wwf         , Ce          , Wwf         , Gs          , Wwg         , Wwg         , Wwf         , Hh^Fds      , Ce          , Ce          , Wwf         , Gs^Fds      , Mm^Xm       , Gd          , Gd          , Gs^Em       , Gs^Em       , Mm          , Mm^Xm       , Hh^Tf       , Gs          , Gs          , Gs          , Mm^Xm       , Wwf         , Gg          , Gg          , Hh^Fds      , Wwg         , Wwg         , Gs^Ve       , Gs          , Hh          
Gs^Fms      , Gs          , Gs          , Wwf         , Hh^Fp       , Wwf         , Hh^Vud      , Hh^Tf       , Wwf         , Ce          , Wwf         , Ke          , Wwf         , Hh          , Gs^Em       , Gd          , Aa^Tf       , Aa          , Sm          , Gs^Em       , Hh^Fp       , Mm^Xm       , Gs          , Gs          , Gs          , Gs^Fds      , Wwg         , Gs^Efm      , Gs          , Gs          , Wwf         , Gs^Fms      , Gg          , Gg          , Ss          
Wwg         , Gg          , Gg          , Gg          , Hh          , Mm^Xm       , Mm^Xm       , Gs^Em       , Gs          , Wwf         , Hh^Fmw      , Wwf         , Gs^Em       , Wwf         , Rb          , Rb^Es       , Aa^Fpa      , Ha          , Ai          , Rb^Es       , Rb          , Gs          , Wwf         , Gs^Em       , Gs^Em       , Gs          , Wwg         , Wwg         , Wwf         , Wwf         , Gs          , Gs          , Gg          , Gg^Efm      , Gs^Fdw      
Mm^Xm       , Gg          , Gg          , Gs          , Gs^Efm      , Hh          , Gs^Em       , Gs          , Gs^Fms      , Mm^Xm       , Hh          , Gs          , Rb^Es       , Wwf         , Wwf         , Rb^Es       , Ai          , Ai          , Ms^Xm       , Ai          , Wwf         , Wwf         , Mm          , Wwf         , Wwf         , Wwf         , Mm^Xm       , Mm^Xm       , Mm^Xm       , Hh^Fp       , Gg          , Gs          , Gg          , Gs          , Gs^Fms      
Hh          , Gll^Vu      , Gg          , Gg          , Gg          , Gs^Em       , Gs          , Gs          , Gs          , Mm^Xm       , Gs^Em       , Gs          , Rb^Es       , Ha^Fpa      , Ms^Xm       , Wwf         , Wwf         , Ai          , Ai          , Wwf         , Wwf         , Rb^Es       , Rb          , Hh^Fp       , Gd          , Hh^Fmw      , Ss          , Hh          , Gs          , Gg          , Gg          , Ce          , Ce          , Hh          , Wwg         
Hh          , Gg          , Gg          , Gs^Fp       , Gg          , Gs          , Mm          , Gs^Em       , Gs          , Gs          , Gd^Em       , Rb^Es       , Aa^Fpa      , Ms          , Wwf         , Wwf         , Ai          , Ai          , Ai          , Wwf         , Rb^Es       , Rb          , Rb^Es       , Rb^Es       , Aa^Vla      , Gd          , Gs^Fdw      , Gs^Em       , Gg          , Gg          , Gg          , Ke          , Ce          , Hh^Fds      , Hh          
Gs^Fds      , Gs          , Gs          , Gg          , Gg          , Hh^Fdw      , Mm^Xm       , Hh^Tf       , Gs          , Gs          , Gd^Em       , Aa          , Ha          , Ms^Xm       , Aa^Fpa      , Ai          , Ms^Xm       , Ms^Xm       , Ms^Xm       , Ai          , Aa^Fpa      , Aa          , Ha          , Aa          , Gd          , Gd^Em       , Gs          , Gs          , Mm^Xm       , Gg^Efm      , Gs          , Gg          , Gs          , Gs          , Mm^Xm       
Ss          , Gs          , Ce          , Gg          , Gg^Efm      , Gs          , Gs          , Gs          , Gd^Fmw      , Gd          , Aa^Voa      , Aa          , Rb^Es       , Aa          , Rb          , Ai          , Ai          , Ms^Xm       , Ai          , Ai          , Wwf         , Ms^Xm       , Aa^Fpa      , Aa          , Gd^Em       , Gs          , Gs          , Hh^Tf       , Mm          , Hh^Fms      , Gg          , Gs          , Gg          , Gg          , Hh          
Ss          , Hh^Fp       , Ce          , Ke          , Gs          , Gs          , Gs^Em       , Gs^Em       , Ss          , Gd          , Gd^Em       , Rb          , Rb          , Rb^Es       , Wwf         , Wwf         , Ai          , Ai          , Wwf         , Wwf         , Ms^Xm       , Ms          , Rb          , Rb          , Gs          , Gs          , Gs          , Gs          , Gg          , Gg          , Gs          , Gs^Fp       , Gg          , Gg          , Ss          
Mm^Xm       , Hh          , Gg          , Ce          , Gg          , Gg          , Mm^Xm       , Hh          , Mm^Xm       , Hh^Fms      , Wwf         , Hh^Fp       , Mm          , Rb^Es       , Wwf         , Wwf         , Ms^Xm       , Ai          , Ai          , Wwf         , Wwf         , Ha^Fpa      , Rb^Es       , Gs          , Hh          , Mm^Xm       , Gs^Fds      , Gs^Em       , Gs          , Gg          , Gs          , Gg          , Gs          , Gs^Vd       , Hh^Fmw      
Mm^Xm       , Gg          , Gs          , Gg          , Gg          , Hh^Fds      , Wwf         , Mm^Xm       , Wwg         , Wwf         , Gs^Em       , Wwf         , Wwf         , Wwf         , Rb^Es       , Ai          , Ai          , Ai          , Aa^Fpa      , Rb^Es       , Rb          , Wwf         , Gs^Em       , Gs          , Hh^Fp       , Mm^Xm       , Gs          , Gs          , Mm^Xm       , Hh          , Hh          , Gg          , Gs          , Gs          , Mm          
Wwg         , Gg          , Gg          , Gs          , Wwf         , Wwf         , Gs          , Wwg         , Wwg         , Gs          , Gs          , Gs^Em       , Gs^Em       , Gs^Em       , Hh^Fmw      , Rb^Es       , Sm          , Ha          , Aa^Tf       , Rb          , Gs^Em       , Wwf         , Wwf         , Wwf         , Wwf         , Wwf         , Wwf         , Gs^Em       , Hh^Vc       , Mm^Xm       , Hh^Fmw      , Gg          , Gg          , Gs          , Gs^Fdw      
Ss          , Gg          , Gs^Vhs      , Gs^Fms      , Wwg         , Gs          , Gs          , Gs^Efm      , Wwf         , Gs^Fp       , Gs          , Gs          , Gs          , Mm^Xm       , Mm^Xm       , Gs          , Gs          , Aa          , Gd          , Gd^Em       , Mm^Xm       , Hh          , Wwf         , Ke          , Ce          , Ce          , Wwf         , Hh^Tf       , Wwg         , Wwf         , Wwf         , Wwf         , Wwf         , Gg^Efm      , Wwf         
Gll^Tf      , Gg          , Gg          , Wwg         , Mm          , Hh^Fmw      , Gg          , Gs          , Wwf         , Mm^Xm       , Mm^Xm       , Gs          , Gs          , Hh^Tf       , Hh          , Mm          , Gs          , Gs^Em       , Gs^Em       , Gs          , Hh^Fdw      , Gs^Fmw      , Wwf         , Ce          , Mm          , Hh^Fms      , Gs          , Wwg         , Gs          , Gs          , Gg          , Ce          , Ce          , Wwf         , Ce          
Gs^Fp       , Gg^Efm      , Wwf         , Wwg         , Gs          , Hh          , Gg          , Gs          , Wwf         , Hh^Fds      , Mm^Xm       , Gs^Em       , Gs^Em       , Gs          , Gs          , Gs          , Gs          , Gs          , Gs^Fp       , Gs          , Wwf         , Hh          , Wwf         , Gs          , Mm^Xm       , Mm^Xm       , Gs          , Wwg         , Gg^Efm      , Gs^Fp       , Gg          , Gs          , Ce          , 4 Ke        , Ce          
Wwf         , Wwf         , Gs          , Gs          , Gs          , Gg          , Gg          , Gg          , Gs          , Wwf         , Wwf         , Gs^Em       , Gs          , Gs^Fdw      , Mm^Xm       , Gs          , Gs^Em       , Gs^Vhs      , Wwf         , Wwf         , Mm^Xm       , Wwf         , Gg^Efm      , Gs          , Gs^Fdw      , Ss          , Gg          , Wwf         , Wwf         , Gs          , Gs          , Ce          , Gs          , Ce          , Hh^Fp       
Gs^Fdw      , Gs^Fds      , Gg^Efm      , Gg          , Gll^Tf      , Ss          , Gg          , Gg          , Gs^Fp       , Gs          , Wwf         , Gs          , Gs          , Mm          , Wwf         , Hh^Fds      , Gs          , Gs          , Wwg         , Mm^Xm       , Mm^Xm       , Gll^Tf      , Gg          , Gs          , Gs^Vht      , Gg          , Gg          , Gs^Fms      , Wwf         , Gs          , Gs          , Gs          , Gs          , Ce          , Hh          
Ss          , Gg          , Gg          , Gg          , Gg          , Gg          , Gg          , Gg          , Hh          , Gs^Fms      , Wwf         , Gs^Em       , Wwg         , Wwf         , Wwf         , Wwf         , Gg          , Gg          , Gg          , Wwg         , Hh          , Hh^Fp       , Gg          , Gg          , Gg          , Gg          , Gg          , Wwg         , Mm          , Hh^Fmw      , Gg          , Gs          , Gg          , Ss          , Mm          
Mm^Xm       , Gg          , Gs          , Gg          , Gs          , Gs          , Gs          , Gs^Fmw      , Wwf         , Wwf         , Wog         , Wwg         , Wog         , Wwg         , Wwg         , Wwf         , Gs^Efm      , Gs          , Gg          , Wwg         , Gs          , Gs          , Gs          , Gs          , Gs          , Gg          , Gs          , Wwg         , Wwg         , Gs^Fds      , Gg          , Gg          , Gll^Vu      , Hh          , Hh^Tf       
Mm^Xm       , Ss          , Ss          , Gs          , Hh          , Gg^Efm      , Gg          , Gg          , Wwf         , Wwg         , Wog         , Wog         , Wog         , Wwg         , Wwg         , Hh^Fmw      , Ce          , Gs          , Gs          , Wwg         , Wwg         , Gs          , Gll^Tf      , Gs          , Gg^Efm      , Gg          , Gg          , Hh^Fds      , Gs^Fms      , Wwf         , Wwf         , Gg          , Gs          , Gg          , Ss          
_off^_usr          , Mm^Xm       , Mm^Xm       , Hh^Fdw      , Mm          , Gg          , Gs          , Gg          , Wwf         , Wwg         , Wwg         , Wog         , Wwg         , Wog         , Ke          , Ce          , Gs          , Gg          , Gg          , Gg          , Gs          , Wwg         , Wwg         , Hh          , Gg          , Gg          , Gs          , Gs          , Gg          , Gs          , Wwf         , Gs          , Gs^Efm      , Gg          , Hh^Fdw      
_off^_usr          , _off^_usr          , _off^_usr          , Mm^Xm       , Mm^Xm       , Gs^Fms      , Gs          , Gs          , Gs          , Wwf         , Wwf         , Wwg         , Wwf         , Wwf         , Wwf         , Ce          , Gg          , Gg          , Gs^Fds      , Hh^Vud      , Gs          , Gs          , Gs          , Wwf         , Ce          , Gs          , Gs          , Gs          , Gg          , Gg          , Gs          , Wwg         , Wwg         , Gs          , Mm          
_off^_usr          , _off^_usr          , _off^_usr          , _off^_usr          , _off^_usr          , Mm^Xm       , Mm^Xm       , Gs          , Gg          , Gs^Vo       , Gg          , Wwf         , Gs          , Gs^Fdw      , Wwf         , Gg          , Gs          , Gs          , Gs          , Hh^Fms      , Gg          , Gg          , Gg          , Wwf         , 1 Ke        , Ce          , Ce          , Gg          , Gs^Fdw      , Gll^Vhc     , Gs          , Gll^Tf      , Wwg         , Hh          , Mm^Xm       
_off^_usr          , _off^_usr          , _off^_usr          , _off^_usr          , _off^_usr          , _off^_usr          , _off^_usr          , Mm^Xm       , Mm^Xm       , Gg          , Hh          , Gg          , Hh^Tf       , Gs          , Wwf         , Wwf         , Gg          , Gs^Efm      , Gs          , Gs          , Ss          , Mm          , Hh          , Wwf         , Ce          , Ce          , Ce          , Ss          , Ss          , Gg          , Gs          , Gs          , Gs          , Wwf         , Wwf         
_off^_usr          , _off^_usr          , _off^_usr          , _off^_usr          , _off^_usr          , _off^_usr          , _off^_usr          , _off^_usr          , _off^_usr          , Mm^Xm       , Mm^Xm       , Mm          , Mm          , Hh          , Mm          , Wwf         , Hh^Fp       , Hh          , Hh          , Hh^Tf       , Mm^Xm       , Hh^Fp       , Mm^Xm       , Wwf         , Wwf         , Ce          , Ce          , Hh^Fp       , Mm          , Mm^Xm       , Hh          , Hh^Fms      , Mm^Xm       , Mm^Xm       , Wwf         
