Xu, Xu, Xu, Xu, Xu, Xu, Xu, Xu, Xu, Xu, Xu, Xu, Xu, Xu, Xu, Xu, Xu, Xu, Xu, Xu, Xu, Xu, Xu, Xu, Xu, Xu, Xu, Xu, Xu, Xu, Xu, Xu, Xu, Xu, Xu, Xu, Xu, Xu
Xu, Xu, Xu, Xu, Xu, Xu, Xu, Xu, Xu, Xu, Xu, Xu, Xu, Xu, Xu, Xu, Xu, Xu, Xu, Xu, Xu, Xu, Xu, Xu, Xu, Xu, Xu, Xu, Xu, Xu, Xu, Xu, Xu, Xu, Xu, Xu, Xu, Xu
Xu, Xu, Xu, Xu, Xu, Xu, Xu, Xu, Xu, Xu, Xu, Xu, Xu, Xu, Xu, Xu, Gs^Fp, Xu, Ww, Wo, Ww, Xu, Gs^Fp, Xu, Xu, Xu, Xu, Xu, Xu, Xu, Xu, Xu, Xu, Xu, Xu, Xu, Xu, Xu
Xu, Xu, Xu, Xu, Xu, Xu, Xu, Xu, Xu, Xu, Xu, Xu, Gs^Fp, Gs^Fp, Gs^Fp, Gs^Fp, Rp, Gs^Fp, Gs^Fp, Ww, Gg^Efm, Gs^Fp, Gs^Fp, Gs^Fp, Gs^Fp, Gs^Fp, Gs^Fp, Xu, Xu, Xu, Xu, Xu, Xu, Xu, Xu, Xu, Xu, Xu
Xu, Xu, Xu, Xu, Xu, Xu, Xu, Xu, Xu, Xu, Cf, Gs^Fp, Gg, Gs^Fp, Rp, Rp, Ww, Ss^Vhs, Gs^Fp, Ww, Gg, Gg^Vh, Gg^Efm, Gs^Fp, Gg^Efm, Gs^Fp, Gg, Gs^Fp, Cf, Xu, Xu, Xu, Xu, Xu, Xu, Xu, Xu, Xu
Xu, Xu, Xu, Xu, Xu, Xu, Xu, Xu, Cf, 1 Kf, Cf, Gg, Gg^Efm, Gg, Ww, Ww, Gg, Ww, Ww, Ww, Gs^Fp, Gg, Gs^Fp, Gg, Ce, Gg, Gg^Efm, Gg, Cf, 4 Kf, Cf, Xu, Xu, Xu, Xu, Xu, Xu, Xu
Xu, Xu, Xu, Xu, Xu, Xu, Rd, Gg^Efm, Gg, Cf, Gg, Gg, Ww, Ww, Gs^Fp, Gg^Efm, Gs^Fp, Ce, Gs^Fp, Wwf, Gg, Gg, Gs^Fp, Gs^Fp, Gs^Fp, Gg, Gg^Efm, Gg, Gg, Cf, Gg, Gs^Fp, Gs^Fp, Xu, Xu, Xu, Xu, Xu
Xu, Xu, Xu, Xu, Gg, Gg, Gs^Fp, Gs^Fp, Gg, Gg, Wwf, Wwf, Gg, Gs^Fp, Gs^Fp, Gg, Hh, Hh, Gs^Fp, Wwf, Gg^Efm, Chr, Gs^Fp, Hh, Gs^Fp, Gg, Gg, Gg, Gg^Efm, Gg^Efm, Gg, Rp, Rp, Chr, Gs^Fp, Xu, Xu, Xu
Xu, Xu, Rp, Gg^Efm, Gs^Fp, Gg, Gg, Gs^Fp, Gg, Gg, Ww, Gg^Ve, Gs^Fp, Gg, Gg, Gg^Efm, Ss, Gs^Fp, Hh, Wwf, Wwf, Gg, Gs^Fp, Gs^Fp, Gg, Gg^Vc, Gg, Gs^Fp, Mm, Gs^Fp, Gg^Efm, Chr, Rp, Gg^Efm, Gs^Fp, Hh^Fp, Gs^Fp, Xu
Gs^Fp, Gg^Vc, Rp, Mm, Mm^Xm, Gs^Fp, Wwf, Gg^Efm, Wwf, Gs^Fp, Ww, Gg, Gg, Hh, Gs^Fp, Rd, Rd, Ss, Gg, Gs^Fp, Gg^Efm, Wwf, Ww, Gg, Gs^Fp, Gg, Gs^Fp, Mm, Mm^Xm, Gs^Fp, Gg, Hh^Fp, Hh^Fp, Gg, Gg^Vh, Hh, Gs^Fp, Gs^Fp
Gs^Fp, Gg, Gg, Mm, Ww, Ww, Gg, Wwf, Gg, Ww, Wwf, Wwf, Wwf, Gg, Gg, Ss, Gs^Fp, Gg, Hh, Gg, Gs^Fp, Hh, Gg, Wwf, Rp, Gg, Gs^Fp, Mm, Mm, Rp, Gg, Gs^Fp, Hh, Gg, Gg^Efm, Gs^Fp, Wwf, Ww
Ww, Gg^Efm, Wwf, Ww, Mm, Mm, Gg^Efm, Gg, Gs^Fp, Gg, Wwf, Wwf, Ww^Bw/, Ww^Bw/, Rr, Gg, Gg^Ve, Gg^Efm, Gg^Fet, Hh^Vhh, Gg, Mm, Gg, Wwf, Wwf, Gg^Efm, Kv, Gg^Efm, Gs^Fp, Gs^Fp, Gg, Gg^Efm, Chw, Gg, Wwf, Wwf, Rp, Chr
Gs^Fp, Wwf, Rp, Gs^Fp, Hh, Mm, Rp, Gs^Fp, Hh, Wwf, Cv, Kv, Cv, Wwf, Ww, Wwf, Rr, Gg^Efm, Gg, Chs, Hh, Gg, Gs^Fp, Gg^Vh, Gg, Cm, Cv, Cv, Rp, Gg, Gg^Efm, Gg, Ww, Ww, Rp, Chr, Rp, Khr
Gs^Fp, Gs^Fp, Rd, Rp, Rd, Rp, Gs^Fp, Chr, Hh^Fp, Wwf, Wwf, Ds, Hh, Cm, Ww, Wwf, Cf, Rr, Mm, Rd, Rd, Gg^Efm, Gg, Gg^Efm, Rr, Ww, Hh, Hh, Ww, Ww, Wwf, Wwf, Wwf, Gg^Efm, Rp, Rp, Chr, Gg
Wwf, Hh, Gg^Efm, Hh, Gs^Fp, Gg, Hh, Hh^Fp, Gg^Efm, Gs^Fp, Wwf, Gg^Fet, Gg, Wwf, Wo, Ww, Ww, Rr, Rd, Rd, Aa, Gs^Fp, Gg, Rr, Wwf, Wwf, Wwf, Wwf, Hh, Gs^Fp, Rp, Gg, Hh^Fp, Wwf, Ss, Rp, Gg, Gg
Gs^Fp, Wwf, Wwf, Gg^Ve, Gg^Efm, Gg, Gg, Gs^Fp, Gg, Wwf, Gg^Ve, Gg, Gg^Efm, Wwf, Gs^Fp, Ww^Vm, Ww, Gs^Fp, Rd, Hh, Aa^Fpa, Mm, Gg^Efm, Wwf, Ww, Wwf, Wwf, Gs^Fp, Gg, Gg, Rp, Gg^Ve, Gs^Fp, Mm, Wwf, Gg, Gs^Fp, Gs^Fp
Gs^Fp, Gs^Fp, Rd, Wwf, Wwf, Rp, Gg, Gg, Gg^Efm, Wwf, Hh, Gs^Fp, Re^Tf, Gg, Wwf, Ww, Rd, Wwf, Wwf, Ha^Vhha, Ha^Fpa, Rd, Wwf, Wwf, Ss^Vhs, Wwf, Wwf, Rp, Gs^Fp, Gg^Efm, Rp, Hh, Gs^Fp, Hh^Fp, Wwf, Gg^Vc, Hh, Gs^Fp
Mm^Xm, Hh, Gs^Fp, Hh, Aa, Wwf, Wwf, Cf, Ww, Wwf, Wwf, Mm, Ww, Wwf, Rp, Gg^Efm, Aa^Fpa, Rd, Hh^Fp, Wwf, Wwf, Ww, Mm, Gg^Efm, Hh^Fp, Re^Tf, Re, Wwf, Ww, Ds, Hh^Fp, Rp, Wwf, Ss, Rp, Gg, Rd, Ss
Mm^Xm, Mm^Xm, Mm^Xm, Mm, Gs^Fp, Gg, Wwf, Wwf, Gs^Fp, Rp, Rd, Wwf, Hh, Gs^Fp, Gg, Rp, Cv, Mm, Wwr, Wwf, Chw, Rp, Rp, Gg, Gg, Re, Hh, Ww, Ss, Wwf, Wwr, Gg^Efm, Wwf, Rp, Gs^Fp, Gg^Efm, Cf, Rd
Mm^Xm, Mm^Xm, Hh, Ss, Wwf, Wwf, Wwf, Mm, Hh, Rd, Mm^Xm, Gg^Efm, Aa^Fpa, Ms, Aa, Rp, Ha, Wwf, Ww^Bw/, Ww^Bw/, Wwf, Ha, Rp, Gg, Aa, Ha, Gg, Gg, Rd, Rd, Hh, Wwf, Wwf, Gg^Efm, Hh, Mm, Mm^Xm, Mm^Xm
Chs, Hh^Fp, Hh, Chr, Wwf, Gg^Efm, Gg, Wwr, Ww, Rd, Ds, Rp, Gg^Efm, Gg, Gg, Rp, Rp, Chw, Wwf, Wwr, Mm, Cv, Rp, Aa, Rp, Gg, Rp, Gs^Fp, Mm^Xm, Rd, Mm, Gs^Fp, Wwf, Wwf, Wwf, Mm^Xm, Gs^Fp, Mm^Xm
Gs^Fp, Gs^Fp, Rp, Rp, Wwf, Ss, Gg, Hh^Fp, Gg^Ve, Ww, Ww, Gg, Re^Tf, Hh^Fp, Rp, Mm, Ww, Wwf, Wwf, Hh^Fp, Rd, Aa^Fpa, Rp, Gg^Efm, Re^Tf, Mm, Hh^Fp, Rp, Rp, Rp, Ww, Wwf, Hh, Gg, Gg^Efm, Wwf, Ss, Gs^Fp
Rp, Rp, Gg^Vh, Wwf, Hh^Fp, Gs^Fp, Gs^Fp, Gg, Gg, Gs^Fp, Hh, Wwf, Wwf, Ss^Vhs, Wwf, Wwf, Rd, Ha^Fpa, Ha^Vhha, Wwf, Wwf, Rd, Hh, Gg^Efm, Gg, Hh, Gg^Ve, Gs^Fp, Ww, Ww^Bw\, Rp, Chr, Rp, Gg, Gg, Ss, Hh^Fp, Gs^Fp
Chr, Rp, Wwf, Wwf, Gs^Fp, Mm, Hh, Gg^Efm, Rp, Rp, Gg, Gg^Efm, Wwf, Ww, Gg^Efm, Gg, Mm, Aa^Fpa, Hh, Rd, Rd, Ww, Ww, Rp, Gg^Efm, Rp, Wwf, Ww, Mm, Gs^Fp, Gg^Efm, Rp, Gg^Efm, Gg^Efm, Gg^Ve, Wwf, Gs^Fp, Gs^Fp
Ss, Wwf, Rp, Khr, Rp, Hh, Gg, Gg, Chr, Ds, Ww, Wwf, Wwf, Gg^Fet, Gg, Gg, Gs^Fp, Aa, Rd, Gg, Cf, Ww, Ww^Vm, Gs^Fp, Wwf, Wwf, Wwf, Hh, Gs^Fp, Mm, Gg, Gg^Efm, Gg, Gs^Fp, Hh, Wwf, Wwf, Gs^Fp
Ss, Ss, Rp, Rp, Rp, Chr, Wwf, Wwf, Wwf, Ww, Cv, Cv, Cm, Rp, Gg^Vh, Gg, Rp, Rp, Mm, Gg^Efm, Gg, Ww, Ww, Wo, Ww^Bw/, Rp, Gg, Wwf, Wwf, Hh, Gg, Gg, Gg^Fet, Gg, Gg, Gg^Efm, Gs^Ft, Wwf
Gs^Fp, Gs^Fp, Rp, Chw, Ww, Ww, Gg^Efm, Gg, Gg, Ds, Hh, Kv, Wwf, Rp, Gg, Gg^Efm, Gg, Chs, Gg, Gg^Efm, Gg, Gg, Rp, Ww^Bw/, Ww, Hh, Gg^Efm, Gg, Gs^Fp, Ss, Gg, Gs^Fp, Ss, Gs^Fp, Gg, Gg, Gs^Ft, Khw
Chr, Rp, Wwf, Wwf, Gg, Gg^Vh, Gg, Gg, Gs^Fp, Gg, Gg, Gg, Hh, Wwf, Gs^Fp, Gs^Fp, Gs^Fp, Hh, Gs^Fp, Rd, Gs^Vht, Gs^Fp, Gg, Ww, Cm, Cv, Cv, Hh, Gg, Wwf, Gg^Efm, Hh^Fp, Ss, Gs^Fp, Gg^Efm, Gg, Wwf, Ww
Ww, Wwf, Hh, Gs^Fp, Hh, Gg, Hh, Gs^Fp, Mm^Xm, Hh, Gg^Efm, Gg, Gs^Fp, Wwf, Wwf, Ss, Gs^Fp, Hh^Vhh, Hh, Ss, Rd, Gs^Fp, Gg, Wwf, Gg^Fet, Kv, Rp, Gg, Gs^Fp, Wwf, Wwf, Ss, Chs, Ss, Wwf, Wwf, Gs^Fp, Gs^Fp
Xu, Gs^Fp, Gs^Fp, Hh, Gs^Fp, Gg, Gg, Ss, Mm, Gs^Fp, Gg, Gg, Gg, Chr, Gs^Fp, Ww, Wwf, Gg^Efm, Gs^Fp, Ss, Hh, Gg, Gs^Fp, Wwf, Gg, Gg, Hh, Gs^Fp, Wwf, Wwf, Gg^Efm, Gs^Fp, Gg, Gg^Vh, Hh, Gs^Fp, Xu, Xu
Xu, Xu, Xu, Hh, Gs^Fp, Gs^Fp, Gg^Efm, Hh, Gs^Fp, Hh, Gg, Gg^Ve, Gg, Gs^Fp, Hh, Gg^Fet, Wwf, Gg, Chr, Gs^Fp, Mm, Gg, Gg^Efm, Ww, Wwf, Gg, Ww, Ww, Gs^Fp, Gg, Gg, Gg, Gs^Fp, Hh, Xu, Xu, Xu, Xu
Xu, Xu, Xu, Xu, Xu, Gs^Fp, Gg, Gg, Cf, Gg, Gg, Gg^Efm, Gs^Fp, Gs^Fp, Gs^Fp, Gg^Efm, Gs^Fp, Wwf, Wwf, Gs^Fp, Hh, Gs^Fp, Ww, Wwf, Gg^Ve, Ww, Gs^Fp, Gs^Fp, Cf, Gg^Efm, Gs^Fp, Gs^Fp, Xu, Xu, Xu, Xu, Xu, Xu
Xu, Xu, Xu, Xu, Xu, Xu, Xu, Cf, 3 Kf, Cf, Gg, Gg, Gg, Hh, Gg, Gg, Gg, Gg^Efm, Ww, Ww, Ww, Gs^Fp, Ww, Wwf, Gg, Gg, Gg, Cf, 2 Kf, Cf, Xu, Xu, Xu, Xu, Xu, Xu, Xu, Xu
Xu, Xu, Xu, Xu, Xu, Xu, Xu, Xu, Xu, Cf, Gg, Gg^Efm, Gs^Fp, Gg, Gs^Fp, Gg^Vh, Gs^Fp, Gs^Fp, Ww, Gs^Fp, Ss^Vhs, Ww, Gg, Gg, Gs^Fp, Gg^Efm, Gs^Fp, Cf, Xu, Xu, Xu, Xu, Xu, Xu, Xu, Xu, Xu, Xu
Xu, Xu, Xu, Xu, Xu, Xu, Xu, Xu, Xu, Xu, Xu, Gs^Fp, Gs^Fp, Ce, Gs^Fp, Gs^Fp, Gs^Fp, Gs^Fp, Ww, Gs^Fp, Gs^Fp, Gg^Efm, Gs^Fp, Gs^Fp, Gs^Fp, Gs^Fp, Xu, Xu, Xu, Xu, Xu, Xu, Xu, Xu, Xu, Xu, Xu, Xu
Xu, Xu, Xu, Xu, Xu, Xu, Xu, Xu, Xu, Xu, Xu, Xu, Xu, Xu, Xu, Ss, Xu, Ww, Wo, Ww, Xu, Gs^Fp, Xu, Xu, Xu, Xu, Xu, Xu, Xu, Xu, Xu, Xu, Xu, Xu, Xu, Xu, Xu, Xu
Xu, Xu, Xu, Xu, Xu, Xu, Xu, Xu, Xu, Xu, Xu, Xu, Xu, Xu, Xu, Xu, Xu, Xu, Xu, Xu, Xu, Xu, Xu, Xu, Xu, Xu, Xu, Xu, Xu, Xu, Xu, Xu, Xu, Xu, Xu, Xu, Xu, Xu
Xu, Xu, Xu, Xu, Xu, Xu, Xu, Xu, Xu, Xu, Xu, Xu, Xu, Xu, Xu, Xu, Xu, Xu, Xu, Xu, Xu, Xu, Xu, Xu, Xu, Xu, Xu, Xu, Xu, Xu, Xu, Xu, Xu, Xu, Xu, Xu, Xu, Xu
