border_size=1
usage=map

Gd, Ds, Dd, Ds, Dd, Ds, Ds, Ds, Ds, Ds, Gd, Gd, Gd, Gd, Gd, Gd, Gd, Gd, Gd, Gd, Rd, Gd, Gd, Gd, Gd, Dd^Ftd, Dd^Ftd, Gd, Dd^Ftd, Gd, Wwt, Wwt
Dd, Dd, Dd, Dd, Ds, Ds, Ds, Ds, Dd^Vda, Rd, Rd, Gd, Gd, Gd, Ww^Ewl, Gd, Gd, Gd, Gd, Dd^Ftd, Ss, Gd, Rd, Gd, Gd, Dd^Ftd, Gd, Dd^Vda, Gd, Wwt, Gd, Gd
Dd, Dd, Ds, Ds, Ds, Gd, Gd, Gd, Gd, Rd, 1 Ket, Ce, Wwf, Wwt, Gd, Ww^Vm, Wwf, Wwf, Wwf, Dd^Vda, Gd, Md^Xm, Gd, Gd, Gd^Ftd, Gd, Wwf, Gd, Wwf, Wwf, Hhd, Gd
Dd, Dd, Ds, Gd, Gd, Gd, Gd, Gd, Gd, Ce, Ce, Ce, Wwf, Gd, Gd, Gd, Gd, Gd, Gd, Wwt, Wwf, Gd, Gd, Gd, Wwf, Wwf, Gd, Wwt, Md^Xm, Ss, Ds, Gd
Ds, Ds, Gd, Ds, Gd, Gd, Gd, Gd, Gd, Gd, Wwt, Wwf, Gd, Gd, Gd, Gd, Hhd, Gd, Gd, Gd, Gd, Wwf, Wwt, Wwt, Gd, Gd, Gd^Ftd, Gd, Gd, Dd^Ftd, Gd, Gd
Ds, Ds, Gd, Gd, Gd, Gd, Gd^Ftd, Rd, Ds, Wwt, Gd, Gd, Hhd, Gd, Gd, Dd^Vda, Md, Gd, Gd, Gd, Gd^Ftd, Gd, Gd, Gd, Gd^Ftd, Gd, Hhd, Ss, Gd, Gd, Gd, Gd
Gd, Gd, Gd, Dd^Ftd, Dd^Vda, Gd, Gd, Dd^Ftd, Gd, Wwf, Gd, Gd, Md^Xm, Gd, Gd, Dd^Ftd, Gd, Gd, Ds, Gd, Md, Gd, Gd, Md^Xm, Rd, Rd, Gd, Rd^Uf, Md^Xm, Gd, Gd, Gd
Gd, Gd, Gd, Ds, Wwt, Ds, Gd, Gd, Gd, Ww^Ewl, Wwt, Gd, Md, Gd, Dd^Vda, Rd, Md^Xm, Dd^Ftd, Dd^Ftd, Gd, Gd, Gd, Gd, Gd, Rd, Gd, Gd, Gd, Gd, Gd, Gd, Gd
Gd, Gd, Gd, Md, Md, Dd^Ftd, Hhd, Gd, Gd, Gd, Gd, Wwf, Wwf, Gd, Rd, Rd, Hhd, Md, Gd, Gd, Dd^Ftd, Hhd, Ss^Vhs, Gd, Rd, Gd, Dd^Ftd, Dd^Vda, Dd^Ftd, Gd, Gd, Gd
Gd, Gd, Gd, Md^Xm, Md^Xm, Md^Xm, Gd, Gd, Md^Xm, Gd, Gd, Gd, Gd, Wwt, Gd, Rd, Gd, Gd, Gd, Gd, Hhd, Ss, Gd^Ftd, Gd, Rd, Gd, Md^Xm, Wwt, Hhd, Gd, Gd, Gd
Md, Gd, Gd, Gd, Gd, Gd, Gd, Gd^Ftd, Ss^Vhs, Ss, Gd^Ftd, Gd, Gd, Wwf, Gd, Gd, Wwf, Gd, Wwf, Gd, Gd, Md, Gd, Rd, Gd, Gd, Gd, Cdr, Ss, Gd, Gd, Gd
Ds, Gd, Dd^Vda, Gd, Gd, Gd, Gd, Gd, Gd^Ftd, Gd^Ftd, Gd, Gd, Wwf, Wwf, Wwf, Wwf, Hhd, Wwf, Wwf, Wwf, Ww^Ewl, Gd, Rd, Rd, Gd, Gd, Dd^Ftd, Gd, Gd, Gd, Ww^Ewf, Dd^Ftd
Ds, Ds, Dd^Ftd, Gd, Gd, Gd, Gd, Gd, Gd, Gd, Wwf, Wwf, Wwf, Ds, Dd^Ftd, Gd^Ftd, Rd^Uf, Cdr, Wwf, Hhd, Dd^Vda, Wwt^Bsb/, Hhd, Dd^Ftd, Ds, Gd, Gd, Dd^Vda, Gd^Ftd, Gd, Dd^Ftd, Dd^Ftd
Ds, Ce, Ce, Wwf, Wwf, Dd^Ftd, Gd, Gd, Wwf^Vm, Gd^Ftd, Wwf, Cdr, Gd, Rd, Rd^Uf, Ss, Rd, Rd, Rd, Rd, Dd^Ftd, Ww^Ewf, Wwf, Md^Xm, Wwf, Wwf, Wwf, Gd, Ce, Ce, 2 Ket, Ds
Ds, 4 Ket, Ce, Ce, Gd, Wwf, Wwf, Wwf, Md^Xm, Wwf, Ww^Ewl, Dd^Ftd, Rd, Rd, Rd, Rd, Ss, Rd^Uf, Rd, Gd, Cdr, Wwf, Gd^Ftd, Wwf^Vm, Gd, Gd, Dd^Ftd, Wwf, Wwf, Ce, Ce, Ds
Dd^Ftd, Dd^Ftd, Gd, Gd^Ftd, Dd^Vda, Gd, Gd, Ds, Dd^Ftd, Hhd, Wwt^Bsb/, Dd^Vda, Hhd, Wwf, Cdr, Rd^Uf, Gd^Ftd, Dd^Ftd, Ds, Wwf, Wwf, Wwf, Gd, Gd, Gd, Gd, Gd, Gd, Gd, Dd^Ftd, Ds, Ds
Dd^Ftd, Wwt, Gd, Gd, Gd, Dd^Ftd, Gd, Gd, Rd, Rd, Gd, Ww^Ewl, Wwf, Wwf, Wwf, Hhd, Wwf, Wwf, Wwf, Wwf, Gd, Gd, Gd^Ftd, Gd^Ftd, Gd, Gd, Gd, Gd, Gd, Dd^Vda, Gd, Ds
Gd, Gd, Gd, Ss, Cdr, Gd, Gd, Gd, Rd, Gd, Md, Gd, Gd, Gd, Gd, Wwf, Gd, Gd, Wwf, Gd, Gd, Gd^Ftd, Ss, Ss^Vhs, Gd^Ftd, Gd, Gd, Rd, Gd, Gd, Gd, Md
Gd, Gd, Gd, Hhd, Wwt, Md^Xm, Gd, Rd, Gd, Gd^Ftd, Ss, Hhd, Gd, Gd, Gd, Gd, Rd, Gd, Wwt, Gd, Gd, Gd, Gd, Md^Xm, Gd, Gd, Md^Xm, Md^Xm, Md^Xm, Gd, Gd, Gd
Gd, Gd, Gd, Dd^Ftd, Dd^Vda, Dd^Ftd, Gd, Rd, Gd, Ss^Vhs, Hhd, Dd^Ftd, Gd, Gd, Md, Hhd, Rd, Rd, Gd, Wwf, Wwf, Gd, Gd, Gd, Gd, Hhd, Dd^Ftd, Md, Md, Gd, Gd, Gd
Gd, Gd, Gd, Gd, Gd, Gd, Gd, Rd, Gd, Gd, Gd, Gd, Gd, Dd^Ftd, Dd^Ftd, Md^Xm, Rd, Dd^Vda, Gd, Md, Gd, Ww^Ewl, Wwt, Gd, Gd, Gd, Ds, Wwt, Ds, Gd, Gd, Gd
Gd, Gd, Gd, Md^Xm, Rd^Uf, Gd, Rd, Rd, Md^Xm, Gd, Gd, Md, Gd, Ds, Gd, Gd, Dd^Ftd, Gd, Gd, Md^Xm, Gd, Gd, Wwf, Gd, Dd^Ftd, Gd, Gd, Dd^Vda, Dd^Ftd, Gd, Gd, Gd
Rd, Gd, Gd, Gd, Ss, Hhd, Gd, Gd^Ftd, Gd, Gd, Gd, Gd^Ftd, Gd, Gd, Gd, Md, Dd^Vda, Rd, Gd, Hhd, Gd, Gd, Wwf, Ds, Rd, Gd^Ftd, Gd, Gd, Gd, Gd, Ds, Ds
Gd, Gd, Dd^Ftd, Gd, Gd, Gd^Ftd, Gd, Gd, Wwt, Wwt, Wwf, Gd, Gd, Gd, Gd, Hhd, Gd, Gd, Gd, Gd, Wwf, Wwt, Gd, Gd, Gd, Gd, Gd, Gd, Ds, Gd, Ds, Ds
Gd, Ds, Ss, Gd, Wwt, Gd, Wwf, Wwf, Gd, Gd, Gd, Wwf, Wwt, Gd, Gd, Gd, Gd, Gd, Gd, Wwf, Ce, Ce, Ce, Gd, Gd, Gd, Gd, Gd, Gd, Ds, Dd, Dd
Gd, Hhd, Wwf, Wwf, Gd, Wwf, Gd, Gd^Ftd, Gd, Gd, Md^Xm, Dd^Ftd, Dd^Vda, Wwf, Wwf, Wwf, Ww^Vm, Gd, Ww^Ewf, Wwf, Ce, 3 Ket, Rd, Gd, Gd, Ds, Ds, Ds, Dd, Dd, Dd, Ds
Gd, Gd, Ww^Ewf, Gd, Dd^Vda, Gd, Dd^Ftd, Gd, Gd, Gd, Gd, Ss, Dd^Ftd, Gd, Gd, Gd, Gd, Wwt, Gd, Gd, Gd, Rd, Rd, Dd^Vda, Ds, Gd, Ds, Dd, Dd, Dd, Ds, Ds
Wwt, Wwt, Gs, Dd^Ftd, Gd, Dd^Ftd, Dd^Ftd, Gd, Gd, Gd, Gd, Rd, Gd, Gd, Gd, Gd, Gd, Gd, Gd, Gd, Gd, Gd, Gd, Gd, Ds, Ds, Ds, Dd, Ds, Ds, Ds, Gd
