Xu, Xu, Xu, Xu, Xu, Xu, Xu, Xu, Xu, Xu, Xu, Xu, Xu, Xu, Xu, Xu, Xu, Xu, Xu
Xu, Xu, Xu, Xu, Xu, Xu, Xu, Xu, Gs^Ft, Ww^Vm, Hh, Xu, Xu, Xu, Xu, Xu, Xu, Xu, Xu
Xu, Xu, Xu, Xu, Kud, Cud, Gs, Hh, Mm, Wwf, Wwf, Mm, Gs^Ft, Xu, Xu, Xu, Xu, Xu, Xu
Xu, Xu, Xu, Cud, Xu, Xu, Wwf, Wwf, Wwf, Wwf, Gs^Ft, Wwf, Wwf, Gs, Gs, Cud, Kud, Xu, Xu
Xu, Xu, Gs, Gs, Wwf, Wwf, Gs, Hh^Vhh, Hh, Wwf, Gs, Hh, Dd^Vdt, Wwf, Wwf, Xu, Xu, Cud, Xu
Xu, Hh^Fdw, Wwf, Wwf, Dd^Vdt, Ss, Gs, Gs^Ft, Gs, Wwf, Gs, Gs, Gs, Ss, Gs^Ft, Wwf, Wwf, Gs, Xu
Xu, Mm, Wwf, Gs, Gs, Gs, Gs^Vht, Gs, Uh, Ai, Gs^Ft, Gs, Gs^Vht, Gs, Gs, Gs, Wwf, Ds, Xu
Xu, Hh, Wwf, Gs^Ft, Gs, Gs, Cud, Cud, Kud, Xu, Cud, Cud, Cud, Gs, Gs, Wwf, Gs^Ft, Hh^Vhh, Xu
Xu, Gs^Ft, Wwf, Hh, Gs, Gs^Ft, Xu, Cud, 3 Xu, Xu, Xu, 1 Kud, Xu, Uh, Wwf, Wwf, Wwf, Hh, Xu
Xu, Ss^Vm, Wwf, Gs, Wwf, Ai, Xu, Xu, Xu, Ql^Xo, Xu, Xu, Xu, Ai, Gs, Gs, Wwf, Ss^Vm, Xu
Xu, Hh, Gs^Ft, Wwf, Gs, Uh, Cud, 4 Kud, Cud, Xu, Kud, Cud, Cud, Gs^Ft, Gs, Hh, Wwf, Gs^Ft, Xu
Xu, Hh^Vhh, Wwf, Wwf, Gs, Gs, Gs^Vht, Cud, Gs^Ft, Xu, 2 Uh, Cud, Gs^Vht, Gs, Gs, Gs^Ft, Wwf, Hh, Xu
Xu, Ds, Wwf, Gs, Ss, Gs, Gs, Gs, Gs, Ai, Gs, Gs, Gs, Gs, Ss, Dd^Vdt, Wwf, Mm, Xu
Xu, Mm, Gs, Wwf, Wwf, Dd^Vdt, Gs, Gs, Gs, Wwf, Hh, Gs^Ft, Gs, Gs, Wwf, Wwf, Gs, Gs^Ft, Xu
Xu, Gs^Ft, Gs, Gs, Gs, Wwf, Wwf, Hh, Gs^Ft, Wwf, Wwf, Hh^Vhh, Wwf, Wwf, Gs, Gs, Gs, Hh^Fdw, Xu
Xu, Xu, Cud, Xu, Xu, Gs, Gs^Ft, Wwf, Wwf, Wwf, Mm, Wwf, Gs, Gs, Xu, Xu, Cud, Xu, Xu
Xu, Xu, Xu, Kud, Cud, Gs, Xu, Mm, Hh, Wwf, Gs^Ft, Hh, Xu, Gs, Cud, Kud, Xu, Xu, Xu
Xu, Xu, Xu, Xu, Xu, Xu, Xu, Xu, Xu, Ww^Vm, Xu, Xu, Xu, Xu, Xu, Xu, Xu, Xu, Xu
Xu, Xu, Xu, Xu, Xu, Xu, Xu, Xu, Xu, Xu, Xu, Xu, Xu, Xu, Xu, Xu, Xu, Xu, Xu
