Wwt, Wwt, Wwt, Wwt, Wwt, Wwt, Wwt, Wwt, Wwt, Wwt, Wwt, Wwt, Wwt, Wwt, Wwt, Wwt, Wwt, Wwt, Wwt, Wwt, Wwt, Wwt, Wwt, Wwt, Wwt, Wwt, Wwt, Wwt, Wwt, Wwt, Wwt, Wwt, Wwt, Wwt, Wwt, Wwt, Wwt, Wwt, Wwt, Wwt, Wwt, Wwt, Wwt, Wwt, Wwt, Wwt, Wwt
Wwt, Wwt, Wwt, Wwt, Wwt, Wwt, Wwt, Wwt, Wwt, Wwt, Wwt, Wwt, Wwt, Wwt, Wwf, Wwf, Wwf, Wwt, Wwt, Wwt, Wwt, Wwt, Wwt, Wwt, Wwt, Wwt, Wwt, Wwt, Wwt, Wwt, Wwf, Wwf, Wwf, Wwt, Wwt, Wwt, Wwt, Wwt, Wwt, Wwt, Wwt, Wwt, Wwt, Wwt, Wwt, Wwt, Wwt
Wwt, Wwt, Wwt, Wwt, Wwt, Wwt, Wwt, Wwt, Wwt, Wwt, Wwf, Wwf, Wwf, Wwf, Rb, Wwf, Wwf, Wwf, Wwf, Wwt, Wwt, Wwt, Wwt, Wwt, Wwt, Wwt, Wwt, Wwt, Wwf, Wwf, Wwf, Wwf, Rb, Wwf, Wwf, Wwf, Wwf, Wwt, Wwt, Wwt, Wwt, Wwt, Wwt, Wwt, Wwt, Wwt, Wwt
Wwt, Wwt, Wwt, Wwt, Wwt, Wwt, Wwt, Wwt, Wwf, Wwf, Wwf, Wwf, Rb, Rb, Ur^Vd, Rb, Xu, Wwf, Wwf, Wwf, Wwf, Wwt, Wwt, Wwt, Wwt, Wwt, Wwf, Wwf, Wwf, Wwf, Xu, Rb, Ur^Vd, Rb, Rb, Wwf, Wwf, Wwf, Wwf, Wwt, Wwt, Wwt, Wwt, Wwt, Wwt, Wwt, Wwt
Wwt, Wwt, Wwt, Wwt, Wwt, Wwt, Wwf, Wwf, Xu, Wwf, Xu, Xu, Rb, Ur^Dr, Ur, Ur, Qlf^Efm, Xu, Xu, Wwf, Wwf, Wwf, Wwf, Wwt, Wwf, Wwf, Wwf, Wwf, Xu, Xu, Qlf^Efm, Ur, Ur, Ur^Dr, Rb, Xu, Xu, Wwf, Xu, Wwf, Wwf, Wwt, Wwt, Wwt, Wwt, Wwt, Wwt
Wwt, Wwt, Wwt, Wwt, Wwf, Wwf, Xu, Xu, Co, Xu, Rb^Emf, Rb, Rb, Xu, Ur, Ur, Ur, Qlf^Efm, Ur^Tf, Rb, Rb, Wwf, Wwf, Wwf, Wwf, Wwf, Rb, Rb, Ur^Tf, Qlf^Efm, Ur, Ur, Ur, Xu, Rb, Rb, Rb^Emf, Xu, Co, Xu, Xu, Wwf, Wwf, Wwt, Wwt, Wwt, Wwt
Wwt, Wwt, Wwt, Wwf, Wwf, Wwf, Xu, Co, 3 Ko, Co, Rb, Rb, Ur^Vd, Ur, Ur, Ur, Ur, Ur^Em, Ur^Vd, Ur, Ur, Rb, Rb, Wwf, Rb, Rb, Ur, Ur, Ur^Vd, Ur^Em, Ur, Ur, Ur, Ur, Ur^Vd, Rb, Rb, Co, 4 Ko, Co, Xu, Wwf, Wwf, Wwf, Wwt, Wwt, Wwt
Wwt, Wwt, Wwf, Wwf, Xu, Xu, Qlf^Efm, Co, Co, Co, Rb, Rb, Ur^Dr, Ur, Qlf^Efm, Ur, Ur, Ur, Ur, Ur^Em, Xur, Ur^Tf, Rb, Rb, Rb, Ur^Tf, Xur, Ur^Em, Ur, Ur, Ur, Ur, Qlf^Efm, Ur, Ur^Dr, Rb, Rb, Co, Co, Co, Qlf^Efm, Xu, Xu, Wwf, Wwf, Wwt, Wwt
Wwt, Wwt, Wwf, Wwf, Wwf, Uu, Ur, Ur^Em, Rb, Rb^Es, Rb, Rb, Ur^Em, Qlf^Efm, Qlf^Efm, Ur, Ur, Ur, Uu, Qlf^Efm, Xur, Gd^Ftd, Gd, Gd, Gd, Gd^Ftd, Xur, Qlf^Efm, Uu, Ur, Ur, Ur, Qlf^Efm, Qlf^Efm, Ur^Em, Rb, Rb, Rb^Es, Rb, Ur^Em, Ur, Uu, Wwf, Wwf, Wwf, Wwt, Wwt
Wwt, Wwt, Wwf, Wwf, Wwf, Wwf, Xu, Rb, Rb^Dr, Rb, Rb, Rb, Rb^Es, Ur^Tf, Ur^Em, Ur, Ur, Ur, Rb^Dr, Xur, Hhd, Gd, Gd, Gd, Gd, Gd, Hhd, Xu, Rb^Dr, Ur, Ur, Ur, Ur^Em, Ur^Tf, Rb^Es, Rb, Rb, Rb, Rb^Dr, Rb, Xu, Wwf, Wwf, Wwf, Wwf, Wwt, Wwt
Wwt, Wwt, Wwf, Ww^Vm, Wwf, Wwf, Wwf, Xu, Xu, Rb, Rb^Em, Rb, Rb, Ur^Vd, Ur^Dr, Ur, Xu, Rb, Gd, Gd^Vd, Gd, Wwf^Es, Hhd, Hhd^Ftd, Hhd, Wwf, Gd, Gd^Vd, Gd, Rb, Xu, Ur, Ur^Dr, Ur^Vd, Rb, Rb, Rb^Em, Rb, Xu, Xu, Wwf, Wwf, Wwf, Ww^Vm, Wwf, Wwt, Wwt
Wwt, Wwt, Wwt, Wwf, Wwt, Wwf, Wwf, Wwf, Wwf^Dr, Uu, Rb, Rb, Rb, Uu, Xu, Gd, Gd, Gd, Gd, Gd^Ftd, Ss^Efm, Wwf, Wwf, Mdd^Fts, Wwf, Wwf, Ss^Efm, Gd^Ftd, Gd, Gd, Gd, Gd, Xu, Uu, Rb, Rb, Rb, Uu, Wwf^Dr, Wwf, Wwf, Wwf, Wwt, Wwf, Wwt, Wwt, Wwt
Wwt, Wwt, Wwt, Wwt, Wwt, Wwt, Wwt, Wwf, Wwf, Ww^Vm, Rb, Rb, Gd, Gd, Gs^Ftd, Ss^Efm, Wwf, Gd^Ftd, Gs, Gs, Wwf, Wwf, Gs, Gs, Gs, Wwf, Wwf, Gs, Gs, Gd^Ftd, Wwf, Ss^Efm, Gs^Ftd, Gd, Gd, Rb, Rb, Ww^Vm, Wwf, Wwf, Wwt, Wwt, Wwt, Wwt, Wwt, Wwt, Wwt
Wwt, Wwt, Wwt, Wwt, Wwt, Wwt, Wwt, Wwf, Wwf^Es, Wwf, Ur, Rb, Gd, Gd, Gd, Ss^Efm, Ss^Efm, Wwf, Wwf^Es, Wwf, Hh, Gs, Gs, Gs^Ftd, Gs, Gs, Hh, Wwf, Wwf, Wwf, Ss^Efm, Ss^Efm, Gd, Gd, Gd, Rb, Ur, Wwf, Wwf, Wwf, Wwt, Wwt, Wwt, Wwt, Wwt, Wwt, Wwt
Wwt, Wwt, Wwt, Wwt, Wwt, Wwt, Wwf, Wwf, Uu, Xu, Qlf^Efm, Xu, Ur, Gd, Gd, Gd, Gs, Gs^Vd, Wwf, Gs^Ftd, Ur, Ur, Ur, Ur, Ur, Gs, Ur, Gs^Ftd, Wwf, Gs^Vd, Gd, Gd, Gd, Gd, Ur, Xu, Qlf^Efm, Xu, Uu, Wwf, Wwf, Wwt, Wwt, Wwt, Wwt, Wwt, Wwt
Wwt, Wwt, Wwt, Wwt, Wwf, Wwf, Ur, Ur, Ur, Ur, Ur, Qlf^Efm, Ur^Tf, Xu, Gd, Gd, Gs^Ftd, Gs^Ftd, Wwf, Ur, Ur^Em, Ur^Fdw, Qlf^Efm, Ur^Dr, Qlf^Efm, Ur^Fdw, Ur^Em, Ur, Wwf, Gs^Ftd, Gd^Ftd, Gd, Gd, Xu, Ur^Tf, Qlf^Efm, Ur, Ur, Ur, Ur, Ur, Wwf, Wwf, Wwt, Wwt, Wwt, Wwt
Wwt, Wwt, Wwf, Wwf, Ur, Ur, Ur, Ur, Ur, Ur, Ur, Ur^Em, Rb, Rb, Rb, Gd^Dr, Xu, Hh, Wwf, Ur, Ur, Ur^Tf, Qlf^Efm, Qlf^Efm, Qlf^Efm, Ur^Tf, Ur, Ur, Wwf^Es, Hh, Xu, Gd^Dr, Rb, Rb, Rb, Ur^Em, Ur, Ur, Ur, Ur, Ur, Ur, Ur, Wwf, Wwf, Wwt, Wwt
Wwt, Wwt, Wwf, Xu, Ur^Dr, Uu, Ur^Vd, Ur^Dr, Ur, Ur, Cer, Ur^Vd, Rb, Rb, Rb, Rb, Gs^Ftd, Gs, Wwf, Ur, Ur, Qlf^Efm, Ur^Em, Ur^Tf, Ur^Em, Qlf^Efm, Ur, Ur, Wwf, Gs, Gs^Ftd, Rb, Rb, Rb, Rb, Ur^Vd, Cer, Ur, Ur, Ur^Dr, Ur^Vd, Uu, Ur^Dr, Xu, Wwf, Wwt, Wwt
Wwt, Wwt, Wwf, Xu, Xu, Qlf^Efm, Qlf^Efm, Ur^Emf, Ur, Cer, Ker, Cer, Rb, Rb, Ur^Vd, Rb, Rb, Rb, Wwf, Wwf, Wwf, Ur, Ur, Ur, Ur, Ur, Wwf, Wwf, Wwf, Rb, Rb, Rb, Ur^Vd, Rb, Rb, Cer, Ker, Cer, Ur, Ur^Emf, Qlf^Efm, Qlf^Efm, Xu, Xu, Wwf, Wwt, Wwt
Wwt, Wwt, Wwf, Wwf, Ur, Xu, Qlf^Efm, Ur, Ur, Cer, Cer, Cer, Ur, Rb, Rb^Dr, Xu, Wwf, Wwf, Wwf, Wwf, Wwt, Wwf, Wwf, Wwf, Wwf, Wwf, Wwt, Wwf, Wwf, Wwf, Wwf, Xu, Rb^Dr, Rb, Ur, Cer, Cer, Cer, Ur, Ur, Qlf^Efm, Xu, Ur, Wwf, Wwf, Wwt, Wwt
Wwt, Wwt, Wwt, Wwf, Wwf, Xu, Xu, Uu, Qlf^Efm, Qlf^Efm, Qlf^Efm, Qlf^Efm, Ur^Tf, Ur, Wwf, Wwf, Wwf, Wwf, Wwt, Wwt, Wwt, Wwt, Wwt, Wwt, Wwt, Wwt, Wwt, Wwt, Wwt, Wwf, Wwf, Wwf, Wwf, Ur, Ur^Tf, Qlf^Efm, Qlf^Efm, Qlf^Efm, Qlf^Efm, Uu, Xu, Xu, Wwf, Wwf, Wwt, Wwt, Wwt
Wwt, Wwt, Wwt, Wwt, Wwt, Wwf, Wwf, Xu, Xu, Xu, Xu, Xu, Wwf, Wwf, Wwf, Wwf, Wwf, Wwf, Wwf^Wkf, Wwt, Wwt, Wwt, Wwt, Wwt, Wwt, Wwt, Wwt, Wwt, Wwf^Wkf, Wwf, Wwf, Wwf, Wwf, Wwf, Wwf, Xu, Xu, Xu, Xu, Xu, Wwf, Wwf, Wwt, Wwt, Wwt, Wwt, Wwt
Wwt, Wwt, Wwt, Wwt, Wwt, Wwt, Wwt, Wwf, Wwf, Wwf, Wwf, Wwf, Wwt, Wwf, Wwf, Wwf, Wwf, Wwf, Rb, Rb, Rb, Wwt, Wwt, Wwt, Wwt, Wwt, Rb, Rb, Rb, Wwf, Wwf, Wwf, Wwf, Wwf, Wwt, Wwf, Wwf, Wwf, Wwf, Wwf, Wwt, Wwt, Wwt, Wwt, Wwt, Wwt, Wwt
Wwt, Wwt, Wwt, Wwt, Wwt, Wwt, Wwt, Wwt, Wwt, Wwt, Wwt, Wwt, Wwt, Wwt, Rb, Rb, Rb, Rb, Gd, Gd, Gd, Rb, Rb, Rb, Rb, Rb, Gd, Gd, Gd, Rb, Rb, Rb, Rb, Wwt, Wwt, Wwt, Wwt, Wwt, Wwt, Wwt, Wwt, Wwt, Wwt, Wwt, Wwt, Wwt, Wwt
Wwt, Wwt, Wwt, Wwt, Wwt, Wwt, Wwt, Wwt, Wwt, Wwt, Wwt, Wwt, Rb, Rb, Gd^Edpp, Gd, Cdr, Gd^Em, Gd, Gd, Gd, Gd, Gd, Gd^Edpp, Gd, Gd, Gd, Gd, Gd, Gd, Cdr, Gd^Edpp, Gd, Rb, Rb, Wwt, Wwt, Wwt, Wwt, Wwt, Wwt, Wwt, Wwt, Wwt, Wwt, Wwt, Wwt
Wwt, Wwt, Wwt, Wwt, Wwt, Wwt, Wwt, Wwt, Wwt, Wwt, Rb, Rb, Rb, Rb, Gd^Vdr, Gd, Gd, Gd^Edpp, Gd, Gd, Gd, Gd^Em, Hhd, Hhd^Ftd, Hhd, Gd^Es, Gd, Gd, Gd^Edpp, Gd, Gd^Em, Gd, Gd^Vdr, Rb, Rb, Rb, Rb, Wwt, Wwt, Wwt, Wwt, Wwt, Wwt, Wwt, Wwt, Wwt, Wwt
Wwt, Wwt, Wwt, Wwt, Wwt, Wwt, Wwt, Wwt, Rb, Rb, Gd, Gd^Ftd, Gd^Gvs, Gd^Gvs, 1 Kdr, Cdr, Gd^Tf, Gd, Gd^Ftd, Gd, Gd^Edp, Hhd, Mdd, Mdd, Mdd, Hhd, Gd^Edp, Gd, Gd^Ftd, Gd, Gd^Tf, Cdr, 2 Kdr, Gd^Gvs, Gd^Gvs, Gd^Ftd, Gd, Rb, Rb, Wwt, Wwt, Wwt, Wwt, Wwt, Wwt, Wwt, Wwt
Wwt, Wwt, Wwt, Wwt, Wwt, Wwt, Wwt, Rb, Rb, Rb, Ss, Gd, Gd, Gd^Gvs, Cdr, Cdr, Gd^Em, Gd, Gd, Gd, Gd^Vdr, Hhd^Ftd, Mdd, Mdd^Ftd, Mdd, Hhd^Ftd, Gd^Vdr, Gd, Gd, Gd, Gd, Cdr, Cdr, Gd^Gvs, Gd, Gd, Ss, Rb, Rb, Rb, Wwt, Wwt, Wwt, Wwt, Wwt, Wwt, Wwt
Wwt, Wwt, Wwt, Wwt, Wwt, Wwt, Rb, Rb, Rb, Ss^Efm, Ss^Efm, Gd, Gd, Gd, Gd, Gd, Gd, Gd, Re, Gd^Ftd, Re, Re, Mdd, Mdd, Mdd, Re, Re, Gd^Ftd, Re, Gd, Gd, Gd, Gd, Gd, Gd, Gd, Ss^Efm, Ss^Efm, Rb, Rb, Rb, Wwt, Wwt, Wwt, Wwt, Wwt, Wwt
Wwt, Wwt, Wwt, Wwt, Wwt, Wwt, Rb, Rb, Wwt, Wwt, Ss^Efm, Ss^Efm, Re, Re, Re, Gd, Re, Re, Gd, Re, Gd, Hhd^Ftd, Hhd, Mdd^Ftd, Hhd, Hhd^Ftd, Gd, Re, Gd, Re, Re, Gd, Re, Re, Re, Ss^Efm, Ss^Efm, Wwt, Wwt, Rb, Rb, Wwt, Wwt, Wwt, Wwt, Wwt, Wwt
Wwt, Wwt, Wwt, Wwt, Wwt, Wwt, Wwt, Wwt, Wwt, Wwt, Ss^Efm, Ss^Efm, Ss^Efm, Gd, Gd^Ftd, Re, Gd, Gd, Gd^Ftd, Gd, Gd, Gd^Es, Gd, Hhd^Ftd, Gd, Gd, Gd, Gd, Gd^Ftd, Gd, Gd, Re, Gd^Ftd, Gd, Ss^Efm, Ss^Efm, Ss^Efm, Wwt, Wwt, Wwt, Wwt, Wwt, Wwt, Wwt, Wwt, Wwt, Wwt
Wwt, Wwt, Wwt, Wwt, Wwt, Wwt, Wwt, Wwt, Wwt, Ss^Efm, Ss^Efm, Ss^Efm, Gd, Gd, Gd^Vdr, Gd, Gd^Em, Gd^Edpp, Gd, Gd, Gd, Gd, Rb, Gd^Em, Rb, Gd, Gd, Gd, Gd, Gd, Gd^Es, Gd, Gd^Vdr, Gd, Gd, Ss^Efm, Ss^Efm, Ss^Efm, Wwt, Wwt, Wwt, Wwt, Wwt, Wwt, Wwt, Wwt, Wwt
Wwt, Wwt, Wwt, Wwt, Wwt, Wwt, Wwt, Wwt, Wwt, Wwt, Wwt, Ss^Efm, Rb, Gd^Es, Mdd, Hhd^Ftd, Mdd, Gd, Gd, Gd, Rb, Rb, Wwt, Rb, Wwt, Rb, Rb, Gd, Gd^Edpp, Gd, Mdd, Hhd^Ftd, Mdd, Gd^Em, Rb, Ss^Efm, Wwt, Wwt, Wwt, Wwt, Wwt, Wwt, Wwt, Wwt, Wwt, Wwt, Wwt
Wwt, Wwt, Wwt, Wwt, Wwt, Wwt, Wwt, Wwt, Wwt, Wwt, Wwt, Wwt, Wwt, Hhd, Hhd, Mdd, Hhd, Hhd, Rb, Rb, Wwt, Wwt, Wwt, Wwt, Wwt, Wwt, Wwt, Rb, Rb, Hhd, Hhd, Mdd, Hhd, Hhd, Wwt, Wwt, Wwt, Wwt, Wwt, Wwt, Wwt, Wwt, Wwt, Wwt, Wwt, Wwt, Wwt
Wwt, Wwt, Wwt, Wwt, Wwt, Wwt, Wwt, Wwt, Wwt, Wwt, Wwt, Wwt, Wwt, Wwt, Wwt, Hhd, Wwt, Wwt, Wwt, Wwt, Wwt, Wwt, Wwt, Wwt, Wwt, Wwt, Wwt, Wwt, Wwt, Wwt, Wwt, Hhd, Wwt, Wwt, Wwt, Wwt, Wwt, Wwt, Wwt, Wwt, Wwt, Wwt, Wwt, Wwt, Wwt, Wwt, Wwt
Wwt, Wwt, Wwt, Wwt, Wwt, Wwt, Wwt, Wwt, Wwt, Wwt, Wwt, Wwt, Wwt, Wwt, Wwt, Wwt, Wwt, Wwt, Wwt, Wwt, Wwt, Wwt, Wwt, Wwt, Wwt, Wwt, Wwt, Wwt, Wwt, Wwt, Wwt, Wwt, Wwt, Wwt, Wwt, Wwt, Wwt, Wwt, Wwt, Wwt, Wwt, Wwt, Wwt, Wwt, Wwt, Wwt, Wwt
