Gd^Fdf      , Sm^Fetd     , Gd^Fdf      , Sm          , Sm^Tf       , Gd^Fdf      , Gd^Fdf      , Wwf         , Gd^Fdf      , Hhd^Fdf     , Sm^Tf       , Gd^Fdf      , Gd^Fdf      , Sm^Tf       , Sm          , Sm^Fetd     , Hhd^Fdf     , Gd^Fdf      , Wwf         , Gd^Fdf      , Gd^Fdf      , Hhd^Fdf     , Hhd^Fdf     , Wwf         , Sm^Fetd     , Hhd^Fdf     , Gd^Fdf      , Gd^Fdf      , Sm          , Gd^Fdf      , Hhd^Fdf     , Gd^Fdf      
Sm          , Gd          , Hhd         , Gd^Fdf      , Gd^Fdf      , Hhd         , Gd^Fdf      , Sm          , Sm^Fetd     , Wwf         , Ce          , Gd^Fdf      , Gd^Fdf      , Hhd         , Gd          , Wwf         , Gd          , Hhd^Fdf     , Ce          , Gd^Fdf      , Wwf         , Gd^Fdf      , Hhd^Fdf     , Sm^Tf       , Gd^Fdf      , Gd          , Wwf         , Ce          , Gd          , Gd^Fdf      , Sm^Fetd     , Gd^Fdf      
Gd^Fdf      , Wwf         , Ce          , Ce          , Wwf         , Gd          , Wwf         , Hhd         , Gd^Fdf      , Gd^Fdf      , Gd          , Wwf         , Gd          , Wwf         , Sm^Vhs      , Hhd^Fdf     , Gd          , Wwf         , Sm          , Gd          , Sm^Fetd     , Gd          , Sm^Vhs      , Gd          , Gd^Fdf      , Hhd         , Gd          , Sm          , Sm^Tf       , Hhd^Fdf     , Wwf         , Sm          
Wwf         , Wwf         , 1 Ke        , Ce          , Ce          , Gd          , Gd          , Gd          , Gd          , Wwf         , Hhd         , Gd          , Gd          , Gd          , Wwf         , Wwf         , Gd          , Hhd^Fdf     , Gd          , Sm^Tf       , Gd          , Wwf         , Wwf         , Gd          , Wwf         , Gd          , Ce          , Wwf         , Gd          , Gd          , Hhd^Fdf     , Ce          
Sm          , Gd          , Gd          , Ce          , Wwf         , Gd          , Hhd^Fdf     , Wwf         , Gd          , Gd^Fdf      , Hhd^Fdf     , Wwf         , Wwf         , Gd^Fdf      , Gd^Fdf      , Gd          , Gd          , Gd          , Wwf         , Gd          , Gd^Fdf      , Ce          , Hhd         , Gd          , Gd          , Hhd         , Ce          , Ce          , Gd          , Wwf         , Gd^Fdf      , Hhd^Fdf     
Gd^Fdf      , Hhd         , Gd          , Sm^Tf       , Hhd         , Wwf         , Gd          , Sm^Vht      , Sm^Tf       , Gd          , Wwf         , Sm^Fetd     , Gd          , Ce          , Hhd         , Md          , Sm^Fetd     , Sm^Tf       , Wwf         , Gd          , Gd          , Hhd^Fdf     , Gd          , Gd          , Gd          , Wwf         , Gd          , 3 Ke        , Ce          , Gd          , Sm^Tf       , Sm^Tf       
Sm          , Sm^Fetd     , Wwf         , Gd          , Wwf         , Gd          , Gd^Fdf      , Wwf         , Wwf         , Gd          , Gd          , Gd          , Gd          , Wwf         , Gd          , Hhd         , Gd          , Gd          , Gd^Fdf      , Hhd^Fdf     , Wwf         , Gd          , Wwf         , Wwf         , Gd^Fdf      , Sm^Tf       , Wwf         , Ce          , Wwf         , Gd          , Wwf         , Sm^Fetd     
Wwf         , Gd          , Gd          , Sm^Vht      , Gd          , Sm^Tf       , Hhd^Fdf     , Gd          , Ce          , Gd          , Wwf         , Sm^Tf       , Wwf         , Gd^Fdf      , Wwf         , Gd          , Gd          , Wwf         , Gd          , Sm^Vht      , Gd          , Gd          , Wwf         , Ce          , Sm^Tf       , Sm          , Gd          , Hhd         , Gd          , Gd^Fdf      , Gd          , Sm^Tf       
Sm          , Ce          , Wwf         , Gd          , Hhd         , Wwf         , Gd          , Gd          , Gd          , Gd^Fdf      , Hhd         , Wwf         , Gd          , Sm^Vhs      , Hhd         , Wwf         , Ce          , Sm^Tf       , Gd          , Wwf         , Hhd         , Sm^Fetd     , Gd          , Gd          , Gd          , Gd          , Sm^Fetd     , Gd          , Gd          , Sm^Vhs      , Wwf         , Gd^Fdf      
Gd^Fdf      , Sm          , Sm^Tf       , Gd          , Wwf         , Sm^Fetd     , Sm          , Sm^Vhs      , Wwf         , Gd          , Wwf         , Gd          , Sm^Fetd     , Wwf         , Gd          , Gd          , Hhd^Fdw     , Hhd         , Wwf         , Gd          , Wwf         , Wwf         , Hhd^Fdw     , Wwf         , Gd          , Wwf         , Sm^Tf       , Hhd^Fdf     , Wwf         , Gd^Fdf      , Ce          , Hhd         
Sm^Fetd     , Gd^Fdf      , Gd          , Gd          , Gd^Fdf      , Hhd^Fdf     , Wwf         , Gd          , Gd^Fdf      , Gd          , Hhd^Fdw     , Hhd         , Sm          , Sm^Fdw      , Wwf         , Wwf         , Gd          , Wwf         , Gd          , Gd          , Gd          , Sm^Tf       , Hhd         , Gd          , Wwf         , Sm^Vht      , Wwf         , Gd          , Gd          , Gd          , Sm          , Gd^Fdf      
Sm^Tf       , Sm^Fdw      , Wwf         , Wwf         , Gd          , Gd          , Hhd         , Gd          , Wwf         , Gd          , Md          , Sm^Tf       , Gd          , Gd          , Hhd         , Sm^Fetd     , Sm^Tf       , Sm^Fdw      , Sm^Vht      , Wwf         , Sm^Fdw      , Sm          , Gd          , Gd          , Ce          , Gd          , Sm          , Sm^Fdf      , Gd          , Sm^Fetd     , Sm          , Wwf         
Wwf         , Sm          , Sm^Fetd     , Gd          , Sm^Fdf      , Sm          , Gd          , Ce          , Gd          , Gd          , Sm          , Sm^Fdw      , Wwf         , Sm^Vht      , Sm^Fdw      , Sm^Tf       , Sm^Fetd     , Hhd         , Gd          , Gd          , Sm^Tf       , Md          , Gd          , Wwf         , Gd          , Hhd         , Gd          , Gd          , Wwf         , Wwf         , Sm^Fdw      , Sm^Tf       
Gd^Fdf      , Sm          , Gd          , Gd          , Gd          , Wwf         , Sm^Vht      , Wwf         , Gd          , Hhd         , Sm^Tf       , Gd          , Gd          , Gd          , Wwf         , Gd          , Wwf         , Wwf         , Sm^Fdw      , Sm          , Hhd         , Hhd^Fdw     , Gd          , Gd^Fdf      , Gd          , Wwf         , Hhd^Fdf     , Gd^Fdf      , Gd          , Gd          , Gd^Fdf      , Sm^Fetd     
Hhd         , Ce          , Gd^Fdf      , Wwf         , Hhd^Fdf     , Sm^Tf       , Wwf         , Gd          , Wwf         , Hhd^Fdw     , Wwf         , Wwf         , Gd          , Wwf         , Hhd         , Hhd^Fdw     , Gd          , Gd          , Wwf         , Sm^Fetd     , Gd          , Wwf         , Gd          , Wwf         , Sm^Vhs      , Sm          , Sm^Fetd     , Wwf         , Gd          , Sm^Tf       , Sm          , Gd^Fdf      
Gd^Fdf      , Wwf         , Sm^Vhs      , Gd          , Gd          , Sm^Fetd     , Gd          , Gd          , Gd          , Gd          , Sm^Fetd     , Hhd         , Wwf         , Gd          , Sm^Tf       , Ce          , Wwf         , Hhd         , Sm^Vhs      , Gd          , Wwf         , Hhd         , Gd^Fdf      , Gd          , Gd          , Gd          , Wwf         , Hhd         , Gd          , Wwf         , Ce          , Sm          
Sm^Tf       , Gd          , Gd^Fdf      , Gd          , Hhd         , Gd          , Sm          , Sm^Tf       , Ce          , Wwf         , Gd          , Gd          , Sm^Vht      , Gd          , Wwf         , Gd          , Gd          , Wwf         , Gd^Fdf      , Wwf         , Sm^Tf       , Wwf         , Gd          , Ce          , Gd          , Hhd^Fdf     , Sm^Tf       , Gd          , Sm^Vht      , Gd          , Gd          , Wwf         
Sm^Fetd     , Wwf         , Gd          , Wwf         , Ce          , Wwf         , Sm^Tf       , Gd^Fdf      , Wwf         , Wwf         , Gd          , Wwf         , Hhd^Fdf     , Gd^Fdf      , Gd          , Gd          , Hhd         , Gd          , Wwf         , Gd          , Gd          , Gd          , Gd          , Wwf         , Wwf         , Gd^Fdf      , Gd          , Wwf         , Gd          , Wwf         , Sm^Fetd     , Sm          
Sm^Tf       , Sm^Tf       , Gd          , Ce          , 4 Ke        , Gd          , Wwf         , Gd          , Gd          , Gd          , Hhd^Fdf     , Gd          , Gd          , Wwf         , Sm^Tf       , Sm^Fetd     , Md          , Hhd         , Ce          , Gd          , Sm^Fetd     , Wwf         , Gd          , Sm^Tf       , Sm^Vht      , Gd          , Wwf         , Hhd         , Sm^Tf       , Gd          , Hhd         , Gd^Fdf      
Hhd^Fdf     , Gd^Fdf      , Wwf         , Gd          , Ce          , Ce          , Hhd         , Gd          , Gd          , Hhd         , Ce          , Gd^Fdf      , Gd          , Wwf         , Gd          , Gd          , Gd          , Gd^Fdf      , Gd^Fdf      , Wwf         , Wwf         , Hhd^Fdf     , Gd^Fdf      , Gd          , Wwf         , Hhd^Fdf     , Gd          , Wwf         , Ce          , Gd          , Gd          , Sm          
Ce          , Hhd^Fdf     , Gd          , Gd          , Wwf         , Ce          , Gd          , Wwf         , Gd          , Wwf         , Wwf         , Gd          , Sm^Tf       , Gd          , Hhd^Fdf     , Gd          , Wwf         , Wwf         , Gd          , Gd          , Gd          , Hhd         , Wwf         , Gd          , Gd          , Gd          , Gd          , Ce          , Ce          , 2 Ke        , Wwf         , Wwf         
Sm          , Wwf         , Hhd^Fdf     , Sm^Tf       , Sm          , Gd          , Hhd         , Gd^Fdf      , Gd          , Sm^Vhs      , Gd          , Sm^Fetd     , Gd          , Sm          , Wwf         , Gd          , Hhd^Fdf     , Sm^Vhs      , Wwf         , Gd          , Wwf         , Gd          , Gd^Fdf      , Gd^Fdf      , Hhd         , Wwf         , Gd          , Wwf         , Ce          , Ce          , Wwf         , Gd^Fdf      
Gd^Fdf      , Sm^Fetd     , Gd^Fdf      , Gd          , Ce          , Wwf         , Gd          , Gd^Fdf      , Sm^Tf       , Hhd^Fdf     , Gd^Fdf      , Wwf         , Gd^Fdf      , Ce          , Hhd^Fdf     , Gd          , Wwf         , Gd          , Hhd         , Gd^Fdf      , Gd^Fdf      , Ce          , Wwf         , Sm^Fetd     , Sm          , Gd^Fdf      , Hhd         , Gd^Fdf      , Gd^Fdf      , Hhd         , Gd          , Sm          
Gd^Fdf      , Hhd^Fdf     , Hhd^Fdf     , Sm          , Wwf         , Gd^Fdf      , Gd^Fdf      , Sm^Fetd     , Wwf         , Hhd^Fdf     , Hhd^Fdf     , Gd^Fdf      , Gd^Fdf      , Wwf         , Gd^Fdf      , Hhd^Fdf     , Sm^Fetd     , Sm          , Sm^Tf       , Gd^Fdf      , Gd^Fdf      , Sm^Tf       , Hhd^Fdf     , Gd^Fdf      , Wwf         , Gd^Fdf      , Gd^Fdf      , Sm^Tf       , Sm          , Gd^Fdf      , Sm^Fetd     , Gd^Fdf      
