border_size=1
usage=map

_s          , _s          , _s          , _s          , _s          , _s          , _s          , _s          , _s          , _s          , _s          , _s          , _s          , _s          , _s          , _s          , _s          , _s          , _s          , _s          , _s          , _s          , _s          , _s          , _s          , _s          , _s          , _s          , _s          , _s          , _s          , _s          , _s          , _s          , _s          , _s          , _s          
_s          , _s          , _s          , _s          , _s          , _s          , _s          , _s          , _s          , _s          , _s          , _s          , Gd          , _s          , Wwf         , _s          , Uue         , _s          , Uh          , _s          , Uue^Em      , _s          , Re          , _s          , Md          , _s          , _s          , _s          , _s          , _s          , _s          , _s          , _s          , _s          , _s          , _s          , _s          
_s          , _s          , _s          , _s          , _s          , _s          , _s          , _s          , _s          , _s          , Gll^Vo      , Gd          , Gd          , Gll         , Wwf         , Uue^Em      , Re          , Re          , Uue^Vu      , Uue^Em      , Uue^Uf      , Re^Fdw      , Re          , Hhd^Fmw     , Gll         , Hhd         , Gd          , _s          , _s          , _s          , _s          , _s          , _s          , _s          , _s          , _s          , _s          
_s          , _s          , _s          , _s          , _s          , _s          , _s          , _s          , Gd          , Gll^Es      , Gd          , Gd^Fmw      , Gd          , Gd          , Rb          , Wwf         , Wwf         , Sm          , Sm          , Re          , Re          , Re          , Uue^Em      , Hhd^Dr      , Gd          , Gd          , Gd          , Gd^Fmw      , Gll^Es      , _s          , _s          , _s          , _s          , _s          , _s          , _s          , _s          
_s          , _s          , _s          , _s          , _s          , _s          , Co          , Re          , Gll^Fp      , Hhd         , Gd          , Gd^Es       , Re          , Ko          , Co          , Rb          , Wwg^Ewl     , Re          , Re          , Uh          , Uue         , Re          , Co          , Ko          , Re          , Gll^Es      , Gd          , Gd          , Gll         , Rb^Uf       , Co          , _s          , _s          , _s          , _s          , _s          , _s          
_s          , _s          , _s          , _s          , Co          , 3 Ko        , Co          , Rb^Uf       , Re          , Md          , Re          , Re          , Re          , Co          , Gll^Fp      , Wwg^Ewl     , Wwg^Ewl     , Wwg         , Ds          , Gd          , Gd^Fdw      , Gd          , Gd          , Co          , Re          , Re          , Re          , Gll^Vo      , Hhd^Fdw     , Sm          , Co          , 2 Ko        , Co          , _s          , _s          , _s          , _s          
_s          , _s          , Wwf         , Re          , Re          , Co          , Hhd^Fdw     , Re          , Hhd^Dr      , Re          , Rb^Gvs      , Rb^Es       , Re          , Gd          , Gd          , Hhd^Fmw     , Gd^Fmw      , Wwg         , Gll^Uf      , Gd          , Gd          , Gd          , Gll^Es      , Hhd^Fdw     , Re          , Gll         , Gll^Es      , Re          , Re          , Re          , Re          , Co          , Re          , Re          , Re          , _s          , _s          
_s          , Hhd^Fmw     , Md          , Wwf         , Re          , Wwg^Ewl     , Re          , Re          , Rb^Es       , Rb^Es       , Rb^Gvs      , Rb^Vc       , Re          , Gd^Es       , Gd          , Gll^Fp      , Gd          , Wwg^Ewl     , Gd          , Hhd^Fmw     , Gd          , Gd          , Gd          , Gll^Es      , Re          , Gd          , Gd^Fmw      , Gd          , Ds          , Ds          , Gd^Fdw      , Re          , Hhd         , Hhd^Fmw     , Wwf         , Wog         , _s          
_s          , Ds          , Sm          , Hhd         , Re          , Re          , Sm          , Sm          , Rb^Gvs      , Rb^Es       , Rb^Es       , Rb^Es       , Re          , Hhd^Fdw     , Ds          , Gd          , Gd          , Gd          , Gll^Es      , Gll         , Gll         , Gd          , Hhd^Dr      , Gll^Vhr     , Re          , Gd          , Wwg         , Wwg         , Wwg^Ewl     , Wwg^Ewl     , Wwg^Ewl     , Re          , Wwf         , Wwf         , Wwf         , Wog         , _s          
_s          , Wwg         , Wwg^Ewl     , Rb^Vhs      , Wog^Bw|     , Gll^Fp      , Gd^Es       , Gll         , Rb^Es       , Rb^Gvs      , Hhd         , Gd^Fdw      , Re          , Ce          , Wwf         , Ds^Esd      , Gll         , Gd^Fdw      , Gd          , Gd          , Rb^Uf       , Hhd         , Gd^Fdw      , Gd^Fmw      , Re          , Rd^Uf       , Wwg^Ewl     , Wog         , Wog         , Wog         , Wwg         , Re          , Hhd^Vl      , Md          , Wwf         , Wog         , _s          
_s          , Wwg         , Ds          , Wwg^Ewl     , Re          , Wwg         , Gd          , Rd^Uf       , Sm          , Ds          , Re          , Re          , Ke          , Ce          , Wwf         , Ds          , Md          , Gll         , Gd          , Gd          , Gd          , Hhd^Fdw     , Wwf         , Ce          , Ke          , Re          , Re          , Wwg         , Wwg^Ewl     , Wwg^Ewl     , Wwg         , Re          , Gd^Fdw      , Gd          , Wwg         , Wog         , _s          
_s          , Ds          , Gd          , Gd^Es       , Ce          , Re          , Re          , Re          , Re          , Re          , Ds          , Wwg         , Wwf         , Wwf         , Md          , Wwf         , Hhd         , Hhd         , Gll         , Gd          , Gd          , Gll         , Gll^Es      , Ce          , Gd^Fmw      , Gd          , Gd          , Re          , Re          , Re          , Re          , Re          , Chw         , Gd          , Wwf         , Wwf         , _s          
_s          , Gd          , Wwg^Ewl     , Gd          , Gll         , Ket         , Ce          , Gd          , Gd^Es       , Hhd^Vhcr    , Hhd^Fmw     , Wwg         , Wwg         , Hhd^Fmw     , Ds^Esd      , Wwf         , Wwf         , Gll         , Gd          , Gd          , Ds          , Gd^Vht      , Gd^Es       , Gd          , Gd          , Gll         , Gll^Es      , Gd^Es       , Gd          , Gd          , Chr         , Khr         , Wo^Bw\      , Wo          , Wwf         , Wwf         , _s          
_s          , Gll^Es      , Gd^Fmw      , Gll         , Gd^Es       , Re          , Re          , Gll         , Gll         , Gll         , Gd          , Gll         , Gd          , Gd          , Gll         , Ds          , Wwg         , Gll^Es      , Wwf^Bs|     , Gll^Fp      , Ds^Esd      , Ds          , Wwf         , Gd          , Ds          , Hhd^Fmw     , Hhd^Dr      , Hhd^Vhhr    , Gll^Es      , Gd          , Ds          , Re^Uf       , Ww          , Wo^Bw\      , Wo^Bw|      , Hh          , _s          
_s          , Hhd^Fmw     , Gll         , Rr^Vd       , Gd          , Gll         , Hhd         , Re          , Gd^Es       , Gll         , Sm          , Gd          , Gll^Es      , Gd          , Gll         , Gll^Fdw     , Wwg         , Wwg         , Chr         , Wwg         , Wwg         , Wwg         , Hhd^Fdw     , Wwf         , Ds          , Md          , Wwf         , Ww          , Ww          , Gd          , Ww          , Ww          , Ww          , Ww          , Gs          , Gs          , _s          
_s          , Gd          , Gd          , Gll         , Gd          , Hhd^Dr      , Md          , Re          , Gd^Fdw      , Sm          , Rb^Uf       , Sm          , Gll         , Gd          , Wwf^Bs\     , Wog         , Wog         , Wog         , Wwf^Bs|     , Wog         , Wog         , Wwf         , Wwf         , Wwg         , Wwg         , Wwf         , Wwf         , Ww          , Ww          , Wo^Bw|      , Ww          , Ww          , Wwf         , Gg^Efm      , Gs^Fds      , Gs          , _s          
_s          , Ds^Uf       , Gd          , Gll         , Gd^Es       , Gd          , Gd          , Re          , Re          , Sm          , Hhd^Fdw     , Gd^Fmw      , Sm          , Ds          , Wwf         , Uu          , Rb          , Uh          , Rb          , Uu          , Wwf^Bs/     , Uu^Uf       , Wog         , Wwg         , Wwg         , Wwg         , Hh          , Gs^Fms      , Gs          , Gs          , Ds          , Ds          , Wwf         , Ds          , Ds          , Gg          , _s          
_s          , Gll^Es      , Gd          , Gd          , Hhd^Fdw     , Gll         , Gd          , Gll         , Gll         , Co          , Ko          , Sm          , Ds          , Ds          , Wwf         , Uu^Fdw      , Sm          , Rb          , Qlf         , Rb          , Sm          , Wwf         , Wwf         , Wog         , Ds          , Ss          , Kh          , Ch          , Gg          , Gg^Efm      , Gg          , Gg          , Hh^Fds      , Wwf         , Gg          , Gs          , _s          
_s          , Gll         , Ds          , Wwf         , Wwf         , Gd          , Ds          , Gll^Es      , Gd          , Co          , Hhd^Dr      , Sm          , Wwg         , Wog         , Wog         , Wwf         , Wwf^Bs/     , Rb          , Rb          , Rb          , Rb          , Uu^Fdw      , Wwf         , Ds          , Ss          , Ss          , Hh^Fds      , Ch          , Rp          , Gg          , Gg          , Gs          , Gs          , Gs          , Gg          , Gg^Efm      , _s          
_s          , Gd          , Gd^Fdw      , Ds          , Wwf         , Ds          , Ww          , Gd          , Ww          , Gd^Fdw      , Wwf         , Wwg         , Wwg         , Wwg         , Wwf         , Uu^Uf       , Wog         , Uu          , Wwf^Bs|     , Uh          , Wog         , Uu          , Wwf^Bs\     , Ds          , Gs          , Gs^Fms      , Rb^Uf       , Ss          , Gs^Fds      , Rp          , Mm          , Gs          , Gs          , Gg          , Gg          , Ds^Uf       , _s          
_s          , Gd^Es       , Gll^Es      , Gd          , Ww          , Ww          , Ww          , Wo^Bw|      , Ww          , Ww          , Wwf         , Wwf         , Ds          , Wwg         , Hh^Fds      , Wwf         , Wwg         , Wog         , Chr         , Wog         , Wwg         , Wog         , Gg^Efm      , Gg          , Gs          , Ss          , Ss          , Ss          , Gs          , Rp          , Hh          , Hh          , Gg          , Gg          , Gs          , Gs          , _s          
_s          , Gd^Es       , Wo^Bw|      , Ww          , Ww          , Ww          , Ds          , Gs          , Gs          , Ww          , Hh          , Mm          , Ds          , Wwf         , Wwf         , Wwg         , Ds          , Wwg         , Wwf^Bs|     , Wwg         , Wwg         , Gg^Fet      , Gs          , Gs          , Gg^Efm      , Gg          , Gs          , Gg          , Gg          , Rp          , Rp          , Gg          , Gg^Efm      , Gg^Ve       , Gs^Fds      , Gs          , _s          
_s          , Hhd         , Wwf         , Wo^Bw\      , Wo^Bw\      , Rp^Uf       , Chr         , Gg          , Gg          , Hh^Vht      , Gs          , Hh^Fp       , Gs          , Gg          , Gg^Efm      , Ds          , Ds          , Gs^Fms      , Gs          , Gs          , Wwf         , Ds          , Ds          , Gs          , Ww          , Gs          , Hh^Fds      , Gg          , Gs          , Gg^Efm      , Ce          , Rp          , Gs          , Gs          , Ww^Ewl      , Hh^Fds      , _s          
_s          , Wwf         , Wwf         , Ww          , Chw         , Khr         , Rp          , Gg^Efm      , Rp          , Gs          , Gs          , Gs          , Gs^Fds      , Gs          , Gg          , Gg^Vda      , Gg          , Gg          , Gg          , Gs          , Hh          , Wwf         , Mm          , Hh^Fp       , Wwf         , Ww          , Ds^Esd      , Hh^Vc       , Rp          , Gs          , Rp          , Ket         , Ce          , Gg          , Gs          , Gg          , _s          
_s          , Wwf         , Ww          , Gs          , Gs^Fms      , Rp          , Ww          , Rp          , Ww          , Rp          , Rp          , Gg^Efm      , Ke          , Ce          , Wwf         , Gs          , Gg          , Gg^Efm      , Gg          , Hh          , Mm          , Wwf         , Wwf         , Wwf         , Ke          , Ww          , Rp          , Rp          , Ss          , Rp          , Gs          , Rp          , Rp          , Gs          , Ds          , Ds          , _s          
_s          , Wo          , Wwf         , Gs          , Hh^Vhh      , Rp          , Ww^Ewl      , Ww          , Wo          , Ww^Ewf      , Ww          , Rp          , Rp          , Ce          , Gs^Fms      , Hh^Fds      , Rb^Uf       , Gg          , Gg          , Gs          , Gs          , Ds          , Wwf         , Ce          , Rp          , Rp          , Hh          , Ds          , Gll^Gvs     , Rb^Uf       , Gs          , Ww          , Wo^Bsb|     , Ww          , Ww^Ewl      , Ww^Ewf      , _s          
_s          , Wo          , Wwf         , Mm          , Wwf         , Rp          , Ww^Ewf      , Wo^Ewf      , Ww          , Wo          , Ww^Ewf      , Rd^Uf       , Rp          , Gs^Fds      , Hh          , Hh          , Gs          , Gg          , Gs          , Gs^Fds      , Gg^Efm      , Ds          , Ds^Esd      , Ce          , Rp          , Gs^Fet      , Gll^Gvs     , Gll^Gvs     , Gll^Gvs     , Gs          , Ss          , Gs^Fms      , Rp          , Rr^Vhc      , Ss          , Ww          , _s          
_s          , Wo          , Wwf         , Wwf         , Hh          , Rp          , Gs^Fet      , Ww^Ewl      , Ds          , Ww          , Gs^Fds      , Gs          , Rp          , Gs^Vh       , Gs          , Gg          , Gs          , Gs          , Gs          , Gg          , Gg          , Gg          , Gg          , Hh^Fms      , Rp          , Gll^Gvs     , Gll^Gvs     , Gll^Gvs     , Gll^Gvs     , Ss          , Rp          , Rp          , Rp          , Hh          , Mm          , Ds          , _s          
_s          , Wo          , Rp          , Hh^Fds      , Rp          , Rp          , Rp          , Ds          , Rp          , Gs          , Gs          , Gg^Efm      , Rp          , Gs          , Gg          , Gg          , Gs          , Hh^Fds      , Rb^Uf       , Ww^Ewl      , Gs^Fms      , Gs^Fds      , Gg^Efm      , Gg          , Rp          , Gs^Vl       , Gs^Wm       , Gll^Gvs     , Hh          , Rp          , Hh^Fp       , Ww^Ewl      , Rp          , Wwf         , Wwf         , Hh^Fms      , _s          
_s          , _s          , _s          , Rp          , Ch          , Ch          , Ch          , Rp          , Hh^Fms      , Rp          , Rp          , Gs          , Rp          , Hh^Fms      , Gg          , Gg^Efm      , Gs^Fms      , Gs          , Ds          , Ww^Ewl      , Ww^Ewf      , Hh^Fp       , Gs^Fds      , Gg          , Rp          , Gs          , Rp          , Rp          , Rp          , Rp          , Ch          , Ch          , Ch          , Rp          , _s          , _s          , _s          
_s          , _s          , _s          , _s          , _s          , 4 Kh        , Ch          , Ss          , Gs          , Rr^Vhc      , Gs          , Rp          , Rp          , Ch          , Ch          , Gs          , Uu^Em       , Gs          , Rb          , Ww^Ewf      , Ww          , Ww          , Ch          , Ch          , Rp          , Rp          , Gs          , Mm          , Gs^Fms      , Rb^Uf       , Ch          , 1 Kh        , _s          , _s          , _s          , _s          , _s          
_s          , _s          , _s          , _s          , _s          , _s          , _s          , Rb^Uf       , Gs          , Gs          , Gg          , Gs          , Gg          , Kh          , Uu^Em       , Rb          , Rb          , Uh          , Sm          , Rb          , Wwf         , Rb          , Rb          , Kh          , Gg          , Gs          , Gg          , Hh          , Gs          , Rp          , _s          , _s          , _s          , _s          , _s          , _s          , _s          
_s          , _s          , _s          , _s          , _s          , _s          , _s          , _s          , _s          , Gs^Fds      , Gg^Efm      , Gs          , Gs          , Hh          , Rb          , Rb          , Uu^Uf       , Rb          , Uu^Vud      , Sm          , Rb          , Wwf         , Wwf         , Gg          , Gg^Efm      , Gs^Fds      , Rr^Vd       , Gs          , _s          , _s          , _s          , _s          , _s          , _s          , _s          , _s          , _s          
_s          , _s          , _s          , _s          , _s          , _s          , _s          , _s          , _s          , _s          , _s          , Hh          , Mm          , Hh^Fp       , Rb          , Rb^Fmw      , Uu^Em       , Uu          , Uh          , Rb          , Uu^Em       , Uu          , Wwf         , Gg          , Gs          , Gs          , _s          , _s          , _s          , _s          , _s          , _s          , _s          , _s          , _s          , _s          , _s          
_s          , _s          , _s          , _s          , _s          , _s          , _s          , _s          , _s          , _s          , _s          , _s          , _s          , _s          , _s          , _s          , _s          , _s          , _s          , _s          , _s          , _s          , _s          , _s          , _s          , _s          , _s          , _s          , _s          , _s          , _s          , _s          , _s          , _s          , _s          , _s          , _s          
