border_size=1
usage=map

Gd^Fdf      , Sm^Fetd     , Gd^Fdf      , Sm          , Sm^Uf       , Gd^Fdf      , Gd^Fdf      , Wwf         , Gd^Fdf      , Hhd^Fdf     , Sm^Uf       , Gd^Fdf      , Gd^Fdf      , Sm^Uf       , Sm          , Sm^Fetd     , Hhd^Fdf     , Gd^Fdf      , Wwf         , Gd^Fdf      , Gd^Fdf      , Hhd^Fdf     , Hhd^Fdf     , Wwf         , Sm^Fetd     , Hhd^Fdf     , Gd^Fdf      , Gd^Fdf      , Sm          , Gd^Fdf      , Hhd^Fdf     , Gd^Fdf      
Sm          , Gd          , Hhd         , Gd^Fdf      , Gd^Fdf      , Hhd         , Gd^Fdf      , Sm          , Sm^Fetd     , Wwf         , Ce          , Gd^Fdf      , Gd^Fdf      , Hhd         , Gd          , Wwf         , Gd          , Hhd^Fdf     , Ce          , Gd^Fdf      , Wwf         , Gd^Fdf      , Hhd^Fdf     , Sm^Uf       , Gd^Fdf      , Gd          , Wwf         , Ce          , Gd          , Gd^Fdf      , Sm^Fetd     , Gd^Fdf      
Gd^Fdf      , Wwf         , Ce          , Ce          , Wwf         , Gd          , Wwf         , Hhd         , Gd^Fdf      , Gd^Fdf      , Gd          , Wwf         , Gd          , Wwf         , Sm^Vhs      , Hhd^Fdf     , Gd          , Wwf         , Sm          , Gd          , Sm^Fetd     , Gd          , Sm^Vhs      , Gd          , Gd^Fdf      , Hhd         , Gd          , Sm          , Sm^Uf       , Hhd^Fdf     , Wwf         , Sm          
Wwf         , Wwf         , 1 Ke        , Ce          , Ce          , Gd          , Gd          , Gd          , Gd          , Wwf         , Hhd         , Gd          , Gd          , Gd          , Wwf         , Wwf         , Gd          , Hhd^Fdf     , Gd          , Sm^Uf       , Gd          , Wwf         , Wwf         , Gd          , Wwf         , Gd          , Ce          , Wwf         , Gd          , Gd          , Hhd^Fdf     , Ce          
Sm          , Gd          , Gd          , Ce          , Wwf         , Gd          , Hhd^Fdf     , Wwf         , Gd          , Gd^Fdf      , Hhd^Fdf     , Wwf         , Wwf         , Gd^Fdf      , Gd^Fdf      , Gd          , Gd          , Gd          , Wwf         , Gd          , Gd^Fdf      , Ce          , Hhd         , Gd          , Gd          , Hhd         , Ce          , Ce          , Gd          , Wwf         , Gd^Fdf      , Hhd^Fdf     
Gd^Fdf      , Hhd         , Gd          , Sm^Uf       , Hhd         , Wwf         , Gd          , Sm^Vht      , Sm^Uf       , Gd          , Wwf         , Sm^Fetd     , Gd          , Ce          , Hhd         , Md          , Sm^Fetd     , Sm^Uf       , Wwf         , Gd          , Gd          , Hhd^Fdf     , Gd          , Gd          , Gd          , Wwf         , Gd          , 3 Ke        , Ce          , Gd          , Sm^Uf       , Sm^Uf       
Sm          , Sm^Fetd     , Wwf         , Gd          , Wwf         , Gd          , Gd^Fdf      , Wwf         , Wwf         , Gd          , Gd          , Gd          , Gd          , Wwf         , Gd          , Hhd         , Gd          , Gd          , Gd^Fdf      , Hhd^Fdf     , Wwf         , Gd          , Wwf         , Wwf         , Gd^Fdf      , Sm^Uf       , Wwf         , Ce          , Wwf         , Gd          , Wwf         , Sm^Fetd     
Wwf         , Gd          , Gd          , Sm^Vht      , Gd          , Sm^Uf       , Hhd^Fdf     , Gd          , Ce          , Gd          , Wwf         , Sm^Uf       , Wwf         , Gd^Fdf      , Wwf         , Gd          , Gd          , Wwf         , Gd          , Sm^Vht      , Gd          , Gd          , Wwf         , Ce          , Sm^Uf       , Sm          , Gd          , Hhd         , Gd          , Gd^Fdf      , Gd          , Sm^Uf       
Sm          , Ce          , Wwf         , Gd          , Hhd         , Wwf         , Gd          , Gd          , Gd          , Gd^Fdf      , Hhd         , Wwf         , Gd          , Sm^Vhs      , Hhd         , Wwf         , Ce          , Sm^Uf       , Gd          , Wwf         , Hhd         , Sm^Fetd     , Gd          , Gd          , Gd          , Gd          , Sm^Fetd     , Gd          , Gd          , Sm^Vhs      , Wwf         , Gd^Fdf      
Gd^Fdf      , Sm          , Sm^Uf       , Gd          , Wwf         , Sm^Fetd     , Sm          , Sm^Vhs      , Wwf         , Gd          , Wwf         , Gd          , Sm^Fetd     , Wwf         , Gd          , Gd          , Hhd^Fdw     , Hhd         , Wwf         , Gd          , Wwf         , Wwf         , Hhd^Fdw     , Wwf         , Gd          , Wwf         , Sm^Uf       , Hhd^Fdf     , Wwf         , Gd^Fdf      , Ce          , Hhd         
Sm^Fetd     , Gd^Fdf      , Gd          , Gd          , Gd^Fdf      , Hhd^Fdf     , Wwf         , Gd          , Gd^Fdf      , Gd          , Hhd^Fdw     , Hhd         , Sm          , Sm^Fdw      , Wwf         , Wwf         , Gd          , Wwf         , Gd          , Gd          , Gd          , Sm^Uf       , Hhd         , Gd          , Wwf         , Sm^Vht      , Wwf         , Gd          , Gd          , Gd          , Sm          , Gd^Fdf      
Sm^Uf       , Sm^Fdw      , Wwf         , Wwf         , Gd          , Gd          , Hhd         , Gd          , Wwf         , Gd          , Md          , Sm^Uf       , Gd          , Gd          , Hhd         , Sm^Fetd     , Sm^Uf       , Sm^Fdw      , Sm^Vht      , Wwf         , Sm^Fdw      , Sm          , Gd          , Gd          , Ce          , Gd          , Sm          , Sm^Fdf      , Gd          , Sm^Fetd     , Sm          , Wwf         
Wwf         , Sm          , Sm^Fetd     , Gd          , Sm^Fdf      , Sm          , Gd          , Ce          , Gd          , Gd          , Sm          , Sm^Fdw      , Wwf         , Sm^Vht      , Sm^Fdw      , Sm^Uf       , Sm^Fetd     , Hhd         , Gd          , Gd          , Sm^Uf       , Md          , Gd          , Wwf         , Gd          , Hhd         , Gd          , Gd          , Wwf         , Wwf         , Sm^Fdw      , Sm^Uf       
Gd^Fdf      , Sm          , Gd          , Gd          , Gd          , Wwf         , Sm^Vht      , Wwf         , Gd          , Hhd         , Sm^Uf       , Gd          , Gd          , Gd          , Wwf         , Gd          , Wwf         , Wwf         , Sm^Fdw      , Sm          , Hhd         , Hhd^Fdw     , Gd          , Gd^Fdf      , Gd          , Wwf         , Hhd^Fdf     , Gd^Fdf      , Gd          , Gd          , Gd^Fdf      , Sm^Fetd     
Hhd         , Ce          , Gd^Fdf      , Wwf         , Hhd^Fdf     , Sm^Uf       , Wwf         , Gd          , Wwf         , Hhd^Fdw     , Wwf         , Wwf         , Gd          , Wwf         , Hhd         , Hhd^Fdw     , Gd          , Gd          , Wwf         , Sm^Fetd     , Gd          , Wwf         , Gd          , Wwf         , Sm^Vhs      , Sm          , Sm^Fetd     , Wwf         , Gd          , Sm^Uf       , Sm          , Gd^Fdf      
Gd^Fdf      , Wwf         , Sm^Vhs      , Gd          , Gd          , Sm^Fetd     , Gd          , Gd          , Gd          , Gd          , Sm^Fetd     , Hhd         , Wwf         , Gd          , Sm^Uf       , Ce          , Wwf         , Hhd         , Sm^Vhs      , Gd          , Wwf         , Hhd         , Gd^Fdf      , Gd          , Gd          , Gd          , Wwf         , Hhd         , Gd          , Wwf         , Ce          , Sm          
Sm^Uf       , Gd          , Gd^Fdf      , Gd          , Hhd         , Gd          , Sm          , Sm^Uf       , Ce          , Wwf         , Gd          , Gd          , Sm^Vht      , Gd          , Wwf         , Gd          , Gd          , Wwf         , Gd^Fdf      , Wwf         , Sm^Uf       , Wwf         , Gd          , Ce          , Gd          , Hhd^Fdf     , Sm^Uf       , Gd          , Sm^Vht      , Gd          , Gd          , Wwf         
Sm^Fetd     , Wwf         , Gd          , Wwf         , Ce          , Wwf         , Sm^Uf       , Gd^Fdf      , Wwf         , Wwf         , Gd          , Wwf         , Hhd^Fdf     , Gd^Fdf      , Gd          , Gd          , Hhd         , Gd          , Wwf         , Gd          , Gd          , Gd          , Gd          , Wwf         , Wwf         , Gd^Fdf      , Gd          , Wwf         , Gd          , Wwf         , Sm^Fetd     , Sm          
Sm^Uf       , Sm^Uf       , Gd          , Ce          , 4 Ke        , Gd          , Wwf         , Gd          , Gd          , Gd          , Hhd^Fdf     , Gd          , Gd          , Wwf         , Sm^Uf       , Sm^Fetd     , Md          , Hhd         , Ce          , Gd          , Sm^Fetd     , Wwf         , Gd          , Sm^Uf       , Sm^Vht      , Gd          , Wwf         , Hhd         , Sm^Uf       , Gd          , Hhd         , Gd^Fdf      
Hhd^Fdf     , Gd^Fdf      , Wwf         , Gd          , Ce          , Ce          , Hhd         , Gd          , Gd          , Hhd         , Ce          , Gd^Fdf      , Gd          , Wwf         , Gd          , Gd          , Gd          , Gd^Fdf      , Gd^Fdf      , Wwf         , Wwf         , Hhd^Fdf     , Gd^Fdf      , Gd          , Wwf         , Hhd^Fdf     , Gd          , Wwf         , Ce          , Gd          , Gd          , Sm          
Ce          , Hhd^Fdf     , Gd          , Gd          , Wwf         , Ce          , Gd          , Wwf         , Gd          , Wwf         , Wwf         , Gd          , Sm^Uf       , Gd          , Hhd^Fdf     , Gd          , Wwf         , Wwf         , Gd          , Gd          , Gd          , Hhd         , Wwf         , Gd          , Gd          , Gd          , Gd          , Ce          , Ce          , 2 Ke        , Wwf         , Wwf         
Sm          , Wwf         , Hhd^Fdf     , Sm^Uf       , Sm          , Gd          , Hhd         , Gd^Fdf      , Gd          , Sm^Vhs      , Gd          , Sm^Fetd     , Gd          , Sm          , Wwf         , Gd          , Hhd^Fdf     , Sm^Vhs      , Wwf         , Gd          , Wwf         , Gd          , Gd^Fdf      , Gd^Fdf      , Hhd         , Wwf         , Gd          , Wwf         , Ce          , Ce          , Wwf         , Gd^Fdf      
Gd^Fdf      , Sm^Fetd     , Gd^Fdf      , Gd          , Ce          , Wwf         , Gd          , Gd^Fdf      , Sm^Uf       , Hhd^Fdf     , Gd^Fdf      , Wwf         , Gd^Fdf      , Ce          , Hhd^Fdf     , Gd          , Wwf         , Gd          , Hhd         , Gd^Fdf      , Gd^Fdf      , Ce          , Wwf         , Sm^Fetd     , Sm          , Gd^Fdf      , Hhd         , Gd^Fdf      , Gd^Fdf      , Hhd         , Gd          , Sm          
Gd^Fdf      , Hhd^Fdf     , Hhd^Fdf     , Sm          , Wwf         , Gd^Fdf      , Gd^Fdf      , Sm^Fetd     , Wwf         , Hhd^Fdf     , Hhd^Fdf     , Gd^Fdf      , Gd^Fdf      , Wwf         , Gd^Fdf      , Hhd^Fdf     , Sm^Fetd     , Sm          , Sm^Uf       , Gd^Fdf      , Gd^Fdf      , Sm^Uf       , Hhd^Fdf     , Gd^Fdf      , Wwf         , Gd^Fdf      , Gd^Fdf      , Sm^Uf       , Sm          , Gd^Fdf      , Sm^Fetd     , Gd^Fdf      
