border_size=1
usage=map

Wwf         , Wwf         , Wwt         , Wwt         , Wwt         , Xuc         , Gs^Ft       , Gs^Ft       , Gs          , Gs          , Ds          , Wwt         , Ds          , Gs          , Gs          , Mm          , Hh          , Mm          , Hh          , Wwt         , Wwf         , Wwt         , Gs          , Gs          , Gs          , Wwt         , Wwt         , Wwt         , Dd^Dc       , Ds          , Wwf         , Md^Xm       , Md^Xm       , Md^Xm       , Md^Xm       , Md^Xm       , Md^Xm       , Md^Xm       
Wwt         , Gs^Ft       , Gs          , Mm          , Hh^Ft       , Wwt         , Ds          , Gs^Ft       , Gs          , Gs          , Gs^Ft       , Wwf         , Ds          , Gs^Do       , Gs^Ft       , Hh          , Gs          , Gs          , Gs          , Wwf         , Rd          , Hh          , Ce          , Mm          , Ce          , Gs^Fet      , Wwt^Vhs     , Md          , Ds          , Ds^Dr       , Wwf         , Wwrt        , Hh^Ft       , Md^Xm       , Mm          , Mm          , Mm          , Md^Xm       
Hh          , Wwf         , Wot         , Wwt         , Hh          , Wwf         , Wwf         , Dd          , Gs          , Gs          , Dd^Vda      , Wwt         , Gs          , Gs          , Cdr         , Gs          , Gs          , Gs          , Mm^Xm       , Wwt         , Chw         , Ce          , Hh          , 3 Ke        , Gs          , Ce          , Ce          , Wwf         , Gs          , Ds          , Ds^Edp      , Wwf         , Wwt         , Hh          , Wwt         , Wwrt        , Hh^Fet      , Md^Xm       
Gs^Ft       , Ds          , Wwf         , Gs^Ft       , Wwrt        , Mm^Xm       , Wwf         , Gs          , Mm          , Hh          , Wwt^Bw|r    , Wwt         , Gs^Dr       , Kdr         , Mm          , Gs          , Gs          , Gs^Vht      , Gs^Uf       , Gs^Ft       , Wwf         , Ds          , Gs          , Gs          , Gs          , Gs          , Hh^Ft       , Wwf         , Wwf         , Gs          , Gs          , Gs^Vht      , Hh          , Wwt         , Wwf         , Hh          , Wwt         , Md^Xm       
Gs^Ft       , Dd^Dc       , Md          , Mm^Xm       , Wwf         , Wwf^Uf      , Gs          , Gs          , Wwf         , Wwf         , Gs          , Gs          , Gs          , Gs          , Gs          , Gs^Ft       , Gs          , Gs          , Ds          , Wwf         , Wwf         , Gs          , Hh^Ft       , Gs          , Gs^Ft       , Hh^Uf       , Md^Xm       , Gs          , Wwf         , Wwt         , Gs^Ft       , Gs^Ft       , Md          , Gs          , Gs^Ft       , Wwt         , Wwf         , Wwf         
Md^Xm       , Mm^Xm       , Gs          , Gs          , Gs^Ft       , Mm^Xm       , Rd          , Rd          , Rd          , Gs^Ft       , Dd          , Rd          , Dd          , Hd          , Rd          , Gs          , Gs^Uf       , Gs          , Rd          , Wwf         , Gs          , Gs          , Gs          , Gs          , Gs          , Gs          , Ds          , Gs          , Wwf         , Hd^Ft       , Mm^Xm       , Md          , Mm^Xm       , Gs          , Rd          , Ds^Edp      , Ds          , Wwt         
Hd          , Dd          , Gs          , Hd          , Mm^Xm       , Md^Xm       , Gs          , Cdr         , Rd          , Hd^Ft       , Gs          , Rd          , Cdr         , Rd          , Dd^Vda      , Gs^Ft       , Gs          , Gs          , Wwf^Bw\r    , Wwt         , Dd^Dc       , Gs          , Gs          , Gs^Ft       , Wwf         , Wwf         , Hh^Uf       , Gs          , Wwt         , Mm^Xm       , Mv          , Mm^Xm       , Mm^Xm       , Rd          , Rd          , Rd          , Dd^Dc       , Ds^Dr       
Hh          , Gs          , Gs          , Gs^Vht      , Gs          , Md^Xm       , Gs^Uf       , Rd^Dr       , Gs          , Rd          , Gs          , Gs^Uf       , Gs          , Dd          , Gs          , Gs          , Gs          , Hd          , Wwrt        , Wwt^Bw\r    , Ds^Bw\r     , Ds^Dr       , Gs          , Wwf^Ft      , Hh          , Gs          , Dd^Vda      , Gs          , Mm^Xm       , Mm^Xm       , Mm^Xm       , Hd          , Rd^Ft       , Rd          , Rd^Ft       , Dd          , Hd          , Ds^Ft       
Wwt         , Wwf         , Wwrt        , Hh          , Wwf         , Gs          , Gs^Ft       , Gs          , Ds          , Gs          , Hh          , Gs          , Gs          , Gs          , Mm          , Gs          , Ke          , Ds          , Gs^Ft       , Wwt^Vm      , Ds^Bw|r     , Gs          , Gs          , Gs          , Gs^Ft       , Hd^Ft       , Rd          , Cdr         , Rd          , Rd          , Rd          , Rd          , Rd          , Rd^Vht      , Rd          , Dd          , Ds          , Md^Xm       
Gs          , Gs^Ft       , Gs^Ft       , Wwt         , Gs          , Gs          , Gs          , Gs          , Gs          , Wwf         , Wwt^Do      , Wwf         , Gs          , Gs          , Hh^Ft       , Ce          , Ce          , Gs          , Gs          , Wwf         , Rd          , Rd          , Gs          , Gs          , Mm^Xm       , Mm          , Rd          , Rd          , Rd          , Rd          , Rd^Uf       , Rd^Dr       , Rd          , Rd          , Dd          , Dd          , Wwt         , Hd          
Mm          , Mm          , Gs          , Gs          , Gs          , Hh^Ft       , Cdr         , Cdr         , Gs          , Wwf         , Wwf^Ft      , Mm          , Mm^Xm       , Gs          , Gs          , Gs          , Gs          , Hh^Uf       , Wwt         , Wwf         , Gs          , Hh          , Mm          , Rd          , Gs          , Dd          , Rd          , Rd^Fetd     , Dd          , Gs          , Gs          , Gs          , Gs          , Rd          , Dd          , Hd^Ft       , Gs^Ft       , Wwt         
Hh          , Hh          , Gs          , Gs          , Mm          , Dd^Vdt      , Kdr         , Dd          , Gs          , Gs          , Gs^Ft       , Mm^Xm       , Mm          , Gs          , Gs^Ft       , Dd          , Md^Xm       , Md^Xm       , Md^Xm       , Wwf         , Gs^Uf       , Gs          , Gs          , Rd          , Ke          , Rd          , Rd          , Wwt^Vm      , Wwf         , Gs^Ft       , Chw         , Gs          , Wwf         , Gs          , Gs          , Gs^Ft       , Wwt         , Wwt         
Rd          , Hh          , Gs^Uf       , Gs          , Hd          , Dd          , Rd          , Rd          , Gs          , Gs          , Gs          , Gs          , Gs          , Gs          , Dd          , Mm          , Gs          , Hd^Ft       , Hd          , Wwf         , Gs^Ft       , Gs^Ft       , Ce          , Ce          , Dd          , Rd          , Wwf^Dr      , Wwf         , Wwt         , Wwf         , Wwf         , Wwt         , Wwf         , Chw         , Wwt^Bw\r    , Wwt         , Gs^Ft       , Gs^Ft       
Rr          , Rd          , Rr^Fetd     , Gs          , Gs          , Gs^Ft       , Rr          , Gs          , Rd          , Dd^Dr       , Dd^Fetd     , Gs          , Hh          , Gs          , Gs          , Gs          , Dd          , Gs          , Gs          , Wwf         , Wwf         , Mm          , Chw         , Rr          , Hd^Ft       , Wwf         , Gs          , Gs          , Hh^Uf       , Wwf         , Wwt         , Gs          , Gs          , Ce          , Gs          , Wwt^Vhs     , Gs^Ft       , Gs^Ft       
Rd          , Rd^Esd      , Rr          , Rd^Edp      , Rr^Dr       , Rd          , Rr^Vhcr     , Rd^Uf       , Rd          , Rr          , Rr          , Rr          , Wwt         , Mm          , Wwf         , Wwt         , Hh^Uf       , Gs^Do       , Hh^Ft       , Wwf         , Gs          , Mm^Xm       , Wwf         , Mm^Xm       , Wwf         , Wwf         , Gs          , Gs^Uf       , Mm          , Hh          , Gs          , Gs          , Gs^Ft       , Ce          , 2 Ke        , Wwt         , Hh^Ft       , Mm          
Md^Xm       , Rd^Dr       , Rd          , Rr          , Rr          , Rd          , Rd          , Rr          , Dd          , Rd          , Hd          , Rd          , Kdr         , Wwf^Uf      , Hd^Ft       , Wwf         , Wwf         , Hd          , Dd^Bw/r     , Wwt^Bw/r    , Wwt^Bw\r    , Rr          , Rr          , Wwf         , Wwf         , Gs          , Gs          , Gs^Ft       , Gs          , Gs          , Hh^Ft       , Hh          , Gs          , Gs          , Ce          , Wwf         , Ds^Ft       , Hh^Ft       
Ds          , Hd^Edp      , Rd          , Rd          , Mm          , Hh^Fetd     , Gs          , Rd          , Gs          , Rr^Dr       , Gs          , Rr          , Gs^Uf       , Chr         , Rd^Dr       , Rr          , Wwf         , Wwt^Bw/r    , Wwt         , Dd^Ft       , Wwrt        , Wwt^Bw\r    , Rd^Bw\r     , Wwf         , Gs^Ft       , Dd^Vdt      , Gs          , Gs          , Rd          , Gs          , Gs          , Gs^Ft       , Mm^Xm       , Mm          , Ce          , Wwf         , Wwt         , Ds^Ft       
Wwt         , Ds          , Ds          , Ce          , Gs          , Gs          , Hh^Ft       , Gs          , Gs          , Gs          , Rd^Ft       , Dd^Fetd     , Rd          , Rd          , Wwf         , Rd^Bw/r     , Dd          , Rd^Uf       , Xu          , Xu          , Rd^Uf       , Dd          , Rd^Bw/r     , Wwf         , Rd          , Rd          , Dd^Fetd     , Rd^Ft       , Gs          , Gs          , Gs          , Gs          , Gs          , Gs          , Ce          , Ds          , Ds          , Wwt         
Ds^Ft       , Wwt         , Wwf         , Ce          , Mm          , Mm^Xm       , Gs^Ft       , Gs          , Gs          , Rd          , Gs          , Gs          , Dd^Vdt      , Gs^Ft       , Wwf         , Rd^Bw\r     , Wwt^Bw\r    , Wwrt        , Dd^Ft       , Wwt         , Wwt^Bw/r    , Wwf         , Rr          , Rd^Dr       , Chr         , Gs^Uf       , Rr          , Gs          , Rr^Dr       , Gs          , Rd          , Gs          , Hh^Fetd     , Mm          , Rd          , Rd          , Hd^Edp      , Ds          
Hh^Ft       , Ds^Ft       , Wwf         , Ce          , Gs          , Gs          , Hh          , Gs          , Gs          , Gs          , Gs^Ft       , Gs          , Gs          , Wwf         , Wwf         , Rr          , Rr          , Wwt^Bw\r    , Wwt^Bw/r    , Dd^Bw/r     , Hd          , Wwf         , Wwf         , Hd^Ft       , Wwf^Uf      , Kdr         , Rd          , Hd          , Rd          , Dd          , Rr          , Rd          , Rd          , Rr          , Rr          , Rd          , Rd^Dr       , Md^Xm       
Mm          , Hh^Ft       , Wwt         , 1 Ke        , Ce          , Gs^Ft       , Gs          , Gs          , Hh          , Mm          , Gs^Uf       , Gs          , Wwf         , Wwf         , Mm^Xm       , Wwf         , Mm^Xm       , Gs          , Wwf         , Hh^Ft       , Gs^Do       , Hh^Uf       , Wwt         , Wwf         , Mm          , Wwt         , Rr          , Rr          , Rr          , Rd          , Rd^Uf       , Rr^Vhcr     , Rd          , Rr^Dr       , Rd^Edp      , Rr          , Rd^Esd      , Rd          
Gs^Ft       , Gs^Ft       , Wwt^Vhs     , Gs          , Ce          , Gs          , Gs          , Wwt         , Wwf         , Hh^Uf       , Gs          , Gs          , Wwf         , Hd^Ft       , Rr          , Chw         , Mm          , Wwf         , Wwf         , Gs          , Gs          , Dd          , Gs          , Gs          , Gs          , Hh          , Gs          , Dd^Fetd     , Dd^Dr       , Rd          , Gs          , Rr          , Gs^Ft       , Gs          , Gs          , Rr^Fetd     , Rd          , Rr          
Gs^Ft       , Gs^Ft       , Wwt         , Wwt^Bw\r    , Chw         , Wwf         , Wwt         , Wwf         , Wwf         , Wwt         , Wwf         , Wwf^Dr      , Rd          , Dd          , Ce          , Ce          , Gs^Ft       , Gs^Ft       , Wwf         , Hd          , Hd^Ft       , Gs          , Mm          , Dd          , Gs          , Gs          , Gs          , Gs          , Gs          , Gs          , Rd          , Rd          , Dd          , Hd          , Gs          , Gs^Uf       , Hh          , Rd          
Wwt         , Wwt         , Gs^Ft       , Gs          , Gs          , Wwf         , Gs          , Chw         , Gs^Ft       , Wwf         , Wwt^Vm      , Rd          , Rd          , Ke          , Rd          , Gs          , Gs          , Gs^Uf       , Wwf         , Md^Xm       , Gs          , Md^Xm       , Dd          , Gs^Ft       , Gs          , Mm          , Mm^Xm       , Gs^Ft       , Gs          , Gs          , Dd          , Kdr         , Dd^Vdt      , Mm          , Gs          , Gs          , Hh          , Hh          
Wwt         , Gs^Ft       , Hd^Ft       , Dd          , Rd          , Gs          , Gs          , Gs          , Gs          , Dd          , Rd^Fetd     , Rd          , Dd          , Gs          , Rd          , Mm          , Hh          , Gs          , Wwf         , Wwt         , Gs          , Gs          , Gs          , Gs          , Gs          , Mm^Xm       , Mm          , Wwf^Ft      , Wwf         , Gs          , Cdr         , Cdr         , Hh^Ft       , Gs          , Gs          , Gs          , Mm          , Mm          
Hd          , Wwt         , Dd          , Dd          , Rd          , Rd          , Rd^Dr       , Rd^Uf       , Rd          , Rd          , Rd          , Rd          , Mm          , Mm^Xm       , Gs          , Gs          , Rd          , Rd          , Wwf         , Gs          , Gs          , Ce          , Ce          , Hh^Ft       , Gs          , Gs          , Wwf         , Wwt^Do      , Wwf         , Gs          , Gs          , Gs          , Gs          , Gs          , Wwt         , Gs^Ft       , Gs^Ft       , Gs          
Md^Xm       , Ds          , Dd          , Rd          , Rd^Vht      , Rd          , Rd          , Rd          , Rd          , Rd          , Cdr         , Rd          , Hd^Ft       , Gs^Ft       , Gs          , Gs          , Gs          , Ds^Bw|r     , Wwt^Vm      , Gs^Ft       , Ds          , Ke          , Gs          , Mm          , Gs          , Gs          , Gs          , Hh          , Gs          , Ds          , Gs          , Gs^Ft       , Gs          , Wwf         , Hh          , Wwrt        , Wwf         , Wwt         
Dd^Ft       , Hd          , Dd          , Rd^Ft       , Rd          , Rd^Ft       , Hd          , Mm^Xm       , Mm^Xm       , Mm^Xm       , Gs          , Dd^Vda      , Gs          , Hh          , Wwf^Ft      , Gs          , Ds^Dr       , Ds^Bw\r     , Wwt^Bw\r    , Wwrt        , Hd          , Gs          , Gs          , Gs          , Dd          , Gs          , Gs^Uf       , Gs          , Rd          , Gs          , Rd^Dr       , Gs^Uf       , Md^Xm       , Gs          , Gs^Vht      , Gs          , Gs          , Hh          
Dd^Dr       , Dd^Dc       , Rd          , Rd          , Rd          , Mm^Xm       , Mm^Xm       , Mv          , Mm^Xm       , Wwt         , Gs          , Hh^Uf       , Wwf         , Wwf         , Gs^Ft       , Gs          , Gs          , Dd^Dc       , Wwt         , Wwf^Bw\r    , Gs          , Gs          , Gs^Ft       , Dd^Vda      , Rd          , Cdr         , Rd          , Gs          , Hd^Ft       , Rd          , Cdr         , Gs          , Md^Xm       , Mm^Xm       , Hd          , Gs          , Dd          , Hd          
Wwt         , Dd          , Dd^Edpp     , Rd          , Gs          , Mm^Xm       , Md          , Mm^Xm       , Hd^Ft       , Wwf         , Gs          , Ds          , Gs          , Gs          , Gs          , Gs          , Gs          , Gs          , Wwf         , Rd          , Gs          , Gs^Uf       , Gs          , Rd          , Hd          , Dd          , Rd          , Dd          , Gs^Ft       , Rd          , Rd          , Rd          , Mm^Xm       , Gs^Ft       , Gs          , Gs          , Mm^Xm       , Md^Xm       
Wwf         , Wwf         , Wwt         , Gs^Ft       , Gs          , Md          , Gs^Ft       , Gs^Ft       , Wwt         , Wwf         , Gs          , Mm^Xm       , Hh^Uf       , Gs^Ft       , Gs          , Hh^Ft       , Gs          , Wwf         , Wwf         , Ds          , Gs          , Gs          , Gs^Ft       , Gs          , Gs          , Gs          , Gs          , Gs          , Wwf         , Wwf         , Gs          , Gs          , Wwf^Uf      , Wwf         , Mm^Xm       , Md          , Dd^Dc       , Gs^Ft       
Md^Xm       , Wwt         , Hh          , Wwf         , Wwt         , Hh          , Gs^Vht      , Gs          , Gs          , Wwf         , Wwf         , Hh^Ft       , Gs          , Gs          , Gs          , Gs          , Ds          , Wwf         , Gs^Ft       , Gs^Uf       , Gs^Vht      , Gs          , Gs          , Mm          , Kdr         , Gs^Dr       , Wwt         , Wwt^Bw|r    , Hh          , Mm          , Gs          , Wwf         , Mm^Xm       , Wwrt        , Gs^Ft       , Wwf         , Ds          , Gs^Ft       
Md^Xm       , Hh^Fet      , Wwrt        , Wwt         , Hh          , Wwt         , Wwf         , Ds^Edpp     , Ds          , Gs          , Wwf         , Ce          , Ce          , Gs          , 4 Ke        , Hh          , Ce          , Chw         , Wwt         , Mm^Xm       , Gs          , Gs          , Gs          , Cdr         , Gs          , Gs          , Wwt         , Dd^Vda      , Gs          , Gs          , Dd          , Wwf         , Wwf         , Hh          , Wwt         , Wot         , Wwf         , Hh          
Md^Xm       , Mm          , Mm          , Mm          , Md^Xm       , Hh^Ft       , Wwrt        , Wwf         , Ds^Dr       , Ds          , Md          , Wwt^Vhs     , Gs^Fet      , Ce          , Mm          , Ce          , Hh          , Rd          , Wwf         , Gs          , Gs          , Gs          , Hh          , Gs^Ft       , Gs^Do       , Ds          , Wwt         , Gs^Ft       , Gs          , Gs          , Gs^Ft       , Ds          , Wwt         , Hh^Ft       , Mm          , Gs          , Gs^Ft       , Wwt         
Md^Xm       , Md^Xm       , Md^Xm       , Md^Xm       , Md^Xm       , Md^Xm       , Wwt         , Wwf         , Ds          , Dd^Dc       , Wwt         , Wwt         , Wwt         , Gs          , Gs          , Gs          , Wwt         , Wwf         , Wwt         , Hh          , Mm          , Hh          , Mm          , Gs          , Gs          , Ds          , Wwt         , Ds          , Gs          , Gs          , Gs^Ft       , Gs^Ft       , Xuc         , Wwt         , Wwt         , Wwt         , Wwf         , Wwf         
