border_size=1
usage=map

_s          , _s          , _s          , _s          , _s          , _s          , _s          , _s          , _s          , _s          , _s          , _s          , _s          , _s          , _s          , _s          , _s          , _s          , _s          , _s          , _s          , _s          , _s          , _s          , _s          , _s          , _s          , _s          , _s          , _s          , _s          , _s          
_s          , Co          , 3 Ko        , Co          , Gll^Es      , Gll^Es      , Hhd         , Hhd         , Rb^Uf       , Aa          , Aa          , Hhd^Fp      , Gd^Es       , Wwf         , Wwg^Ewl     , Wog^Ewl     , Wog^Ewl     , _s          , Wog^Ewl     , _s          , Ds          , _s          , Gll^Es      , _s          , Aa          , _s          , Gd          , _s          , Cud         , _s          , Cud         , _s          
_s          , Co          , Co          , Co          , Gd          , Gll         , Gd          , Md          , Gll         , Gd^Es       , Gd          , Gd          , Ds          , Wwf         , Wwg         , Wog         , Wwg^Ewl     , Wwg^Ewl     , Wwf         , Wwf         , Gd^Fdf      , Gd          , Gll^Es      , Hhd         , Aa          , Gd          , Gll^Es      , Rb^Uf       , Cud         , 2 Kud       , Cud         , _s          
_s          , Gd          , Gd^Es       , Gll         , Gd^Es       , Gd          , Gd          , Gd          , Gll^Fp      , Gll         , Rr^Dr       , Gd          , Gll^Es      , Wwf         , Wwf         , Wwg         , Wwf         , Wwf         , Md          , Ds          , Rd^Uf       , Gll         , Gd          , Aa          , Gd          , Gd          , Gll^Fp      , Gll         , Gd          , Cud         , Gd^Fmw      , _s          
_s          , Gd^Fdw      , Gd          , Gd          , Rb          , Rb^Vo       , Aa^Br\      , Gd^Es       , Gll         , Gll         , Gll         , Rp^Vhcr     , Gll         , Gd^Fdw      , Gll         , Wwf         , Ds          , Wwf         , Gll^Es      , Hhd         , Gll^Vc      , Gd          , Ds^Es       , Gd          , Gd          , Hhd^Fdw     , Rb^Vud      , Gll         , Gd^Es       , Gd          , Hhd         , _s          
_s          , Gd          , Gd^Es       , Gll^Uf      , Rb^Es       , Aa^Fda      , Aa          , Rb^Br\      , Rb^Uf       , Gd          , Co          , Gd          , Gd^Es       , Gll         , Ds^Es       , Wwg^Ewl     , Wwg^Ewl     , Wwg^Ewl     , Wog^Bw/     , Gd          , Gd          , Gd^Es       , Sm          , Sm          , Gd          , Gd          , Wwg^Ewl     , Rb^Br\      , Rb^Br|      , Gll         , Gd          , _s          
_s          , Gd^Es       , Aa          , Rb          , Xuc         , Xu          , Rb^Br/      , Rb^Br|      , Co          , Ko          , Co          , Gd^Es       , Wwf         , Hhd         , Wwf         , Gd^Fmw      , Wwg         , Wog^Bw|     , Wwg         , Gd^Fmw      , Gll         , Cud         , Kud         , Gll         , Gll^Es      , Gll^Es      , Ds          , Gll^Fmf     , Rb^Br/      , Gd          , Gll^Es      , _s          
_s          , Ha^Fpa      , Aa          , Rb          , Uu^Br|      , Sm^Br/      , Uh          , Rb^Br|      , Wwg^Ewl     , Wwf         , Wwg         , Wwf         , Gll         , Wwg^Ewl     , Gll^Vht     , Wwg         , Gll         , Rb          , Ds          , Wwg         , Wwf         , Cud         , Wwg^Ewl     , Cud         , Rb^Br\      , Xu          , Xuc         , Rb^Br|      , Gll         , Gll^Es      , Ha^Fda      , _s          
_s          , Aa          , Xuc         , Rb^Es       , Wwf^Em      , Uu^Vu       , Sm^Br/      , Rb^Br|      , Wog^Bw\     , Wwg         , Gll^Fmf     , Gd^Es       , Gd          , Gd^Es       , Gll         , Hhd^Fdw     , Gd^Es       , Rb^Es       , Rb^Vhr      , Wwg         , Rb^Es       , Wwf         , Wwg^Ewl     , Ds          , Rb          , Rb^Br\      , Wwg^Br|     , Aa^Br/      , Aa          , Ms          , Aa          , _s          
_s          , Xuc         , Rb^Fdw      , Rb^Es       , Rb          , Rb^Fdw      , Ds^Br|      , Wwg         , Uh          , Urb         , Uu^Vo       , Xu          , Hhd         , Gd          , Gll         , Gll         , Gll         , Gll         , Wwg^Ewl     , Rr^Dr       , Xuc         , Xuc         , Uu^Vud      , Wwf         , Rb^Es       , Uh          , Rb^Br|      , Uu^Vu       , Xuc         , Ha          , Aa          , _s          
_s          , Xuc         , Uh          , Uu^Em       , Rb^Es       , Uu^Uf       , Wwg         , Wwg^Ewl     , Wwg^Ewl     , Urb         , Uu^Em       , Xuc         , Md          , Ds^Es       , Gd          , Rb^Uf       , Gd          , Aa          , Hhd^Fp      , Rb          , Rb^Em       , Sm          , Uu^Uf       , Wwf         , Wwg^Ewl     , Rb          , Wwg^Ewl     , Rb^Br\      , Sm^Br|      , Xuc         , Xuc         , _s          
_s          , Wwg         , Wwg         , Wwf         , Wwf         , Wwf         , Uu^Br|      , Wwg^Ewl     , Rb^Fdw      , Urb         , Rb^Em       , Aa          , Rb          , Gd          , Gll^Fmw     , Gd          , Sm          , Gll         , Rb          , Sm          , Uu^Em       , Rb          , Ds          , Wwg^Ewl     , Sm          , Rb^Fdw      , Uu^Em       , Sm          , Ds^Br/      , Rb^Fdw      , Qxu         , _s          
_s          , Wwg^Ewl     , Uu^Uf       , Ds^Em       , Rb^Br/      , Rb^Br/      , Sm          , Sm          , Uu^Em       , Urb         , Urb         , Uu^Uf       , Rb^Es       , Gll^Em      , Aa          , Ha^Vla      , Ms^Xm       , Ms^Xm       , Aa^Fda      , Rb          , Ds^Es       , Rb^Fdw      , Wwg^Ewl     , Uh          , Sm          , Xu          , Rb^Fdw      , Uu^Br|      , Rb          , Uu^Es       , Uh          , _s          
_s          , Uh          , Uu^Es       , Rb^Em       , Uu^Br|      , Rb^Fdw      , Xu          , Sm          , Uh          , Wwg^Ewl     , Rb^Fdw      , Ds^Es       , Rb^Es       , Aa^Fma      , Ms^Xm       , Ms^Xm       , Ha^Vca      , Aa          , Gll^Em      , Rb          , Uu^Uf       , Urb         , Urb         , Uu^Em       , Sm          , Sm          , Rb^Br/      , Rb^Br/      , Ds^Em       , Uu^Uf       , Wwg         , _s          
_s          , Qxu         , Rb^Fdw      , Ds^Br/      , Sm          , Uu^Em       , Rb^Fdw      , Sm          , Wwg^Ewl     , Ds^Em       , Rb^Es       , Uu^Em       , Sm          , Rb          , Gd          , Sm          , Gd          , Gd^Fdf      , Gd          , Rb          , Aa          , Rb^Em       , Urb         , Rb^Fdw      , Wwg^Ewl     , Uu^Br|      , Wwf         , Wwf         , Wwf         , Wwg^Ewl     , Wwg         , _s          
_s          , Xuc         , Xuc         , Sm^Br|      , Rb^Br\      , Wwg^Ewl     , Rb^Es       , Wwg^Ewl     , Wwf         , Uu^Uf       , Sm          , Rb          , Rb^Em       , Hhd^Fmf     , Aa          , Gd^Es       , Rb^Uf       , Gd          , Ds          , Md          , Xuc         , Uu^Es       , Urb         , Wwg         , Wwg^Ewl     , Wwg^Ewl     , Uu^Uf       , Rb^Es       , Uu^Em       , Uh          , Xuc         , _s          
_s          , Aa          , Ha          , Xuc         , Uu^Vud      , Rb^Br|      , Uh          , Rb          , Wwf         , Uu^Vu       , Xuc         , Xuc         , Rr^Dr       , Wwg^Ewl     , Gd          , Gd          , Gll         , Gd          , Gd^Es       , Hhd         , Xu          , Uu^Vu       , Urb         , Uh          , Wwg         , Ds^Br|      , Rb^Fdw      , Rb          , Rb^Es       , Rb^Fdw      , Xuc         , _s          
_s          , Aa          , Ms          , Aa          , Aa^Br|      , Wwg^Br/     , Rb^Br\      , Rb          , Ds          , Wwg^Ewl     , Wwf         , Rb^Es       , Wwg         , Rb^Vhr      , Rb^Es       , Gd          , Hhd^Fp      , Gd          , Gll         , Gd          , Gd          , Gll^Fp      , Wwg^Ewl     , Wog^Bw\     , Rb^Br/      , Sm^Br/      , Uu^Vo       , Wwf^Em      , Rb^Es       , Xuc         , Aa          , _s          
_s          , Ha^Fpa      , Gll         , Gll^Es      , Rb^Br/      , Xuc         , Xu          , Rb^Br\      , Cud         , Wwg^Ewl     , Cud         , Wwf         , Wwg         , Ds^Es       , Rb^Es       , Gll         , Wwg         , Gll^Vht     , Wwg^Ewl     , Gd^Es       , Wwf         , Wwg         , Wwf         , Wwf         , Rb^Br|      , Uh          , Sm^Br/      , Uu^Br|      , Rb          , Aa          , Ha^Fma      , _s          
_s          , Gll^Es      , Gd          , Rb^Br|      , Gll^Fmf     , Ds          , Gll         , Gll         , Gll         , Kud         , Cud         , Gd          , Gll^Fp      , Wwg         , Wog^Bw|     , Wwg         , Gd^Fmw      , Wwf         , Hhd         , Wwf         , Gll         , Co          , Ko          , Co          , Rb^Br|      , Rb^Br/      , Xu          , Xuc         , Rb          , Aa          , Gd          , _s          
_s          , Gd          , Gd^Es       , Rb^Br\      , Rb^Br\      , Wwg^Ewl     , Gd          , Gll^Es      , Sm          , Sm          , Gll         , Gd          , Gd          , Wog^Bw/     , Wwg^Ewl     , Wwg^Ewl     , Wwg^Ewl     , Ds          , Gd          , Gll^Es      , Gll         , Co          , Rb^Uf       , Rb          , Rb^Br\      , Aa          , Aa^Fma      , Rb          , Gll^Uf      , Gll^Es      , Gd          , _s          
_s          , Hhd         , Gd          , Gll         , Gll^Es      , Rb^Vud      , Hhd^Fdw     , Gd          , Gd          , Ds^Es       , Gll         , Gll^Vl      , Hhd         , Gll^Es      , Wwf         , Ds          , Wwf         , Gd          , Gll^Fdw     , Gd          , Rp^Vhcr     , Gd          , Gll^Es      , Gll         , Gd          , Aa^Br\      , Rb^Vo       , Rb          , Gd          , Gd^Es       , Gd^Fmw      , _s          
_s          , Gll^Fp      , Cud         , Gll         , Gd          , Gll^Fdw     , Gd          , Gd          , Aa          , Gd          , Gll^Es      , Rb^Uf       , Ds          , Md          , Wwf         , Wwf         , Wwg^Ewl     , Wwf         , Wwf         , Gll^Es      , Gd          , Rr^Dr       , Gll         , Gd^Fdf      , Gll         , Gd^Es       , Gd          , Gd          , Gll         , Gll         , Gll         , _s          
_s          , Cud         , 1 Kud       , Cud         , Rb^Uf       , Gd^Es       , Gd          , Aa          , Hhd         , Gll         , Gd          , Gd^Fdf      , Wwf         , Wwf         , Wwg^Ewl     , Wwg         , Wog^Ewl     , Wwg^Ewl     , Wwf         , Ds          , Gd          , Gd          , Gd^Es       , Gd          , Md          , Gll         , Gd^Es       , Gll         , Co          , Co          , Co          , _s          
_s          , Cud         , _s          , Cud         , _s          , Gll         , _s          , Aa          , _s          , Gd^Es       , _s          , Ds          , _s          , Wog^Ewl     , _s          , Wog         , Wog^Ewl     , Wwg         , Wwf         , Gll^Es      , Hhd^Fdf     , Aa          , Aa          , Rb^Uf       , Hhd         , Hhd         , Gll^Es      , Gd          , Co          , 4 Ko        , Co          , _s          
_s          , _s          , _s          , _s          , _s          , _s          , _s          , _s          , _s          , _s          , _s          , _s          , _s          , _s          , _s          , _s          , _s          , _s          , _s          , _s          , _s          , _s          , _s          , _s          , _s          , _s          , _s          , _s          , _s          , _s          , _s          , _s          
