border_size=1
usage=map

_off^_usr          , _off^_usr          , _off^_usr          , _off^_usr          , _off^_usr          , _off^_usr          , _off^_usr          , _off^_usr          , _off^_usr          , _off^_usr          , _off^_usr          , _off^_usr          , _off^_usr          , _off^_usr          , _off^_usr          , _off^_usr          , _off^_usr          , _off^_usr          , _off^_usr          , _off^_usr          , _off^_usr          , _off^_usr          , _off^_usr          , _off^_usr          , _off^_usr          , _off^_usr          , _off^_usr          , _off^_usr          , _off^_usr          , _off^_usr          , _off^_usr          , _off^_usr          , _off^_usr          , _off^_usr          , _off^_usr          , _off^_usr          , _off^_usr          
_off^_usr          , _off^_usr          , Ss          , _off^_usr          , Hh          , _off^_usr          , Gs^Em       , _off^_usr          , Gs^Em       , _off^_usr          , Ss          , _off^_usr          , Wwg^Ewf     , _off^_usr          , Gs^Em       , _off^_usr          , Wwg^Ewf     , _off^_usr          , Wwf         , _off^_usr          , Gs^Fms      , _off^_usr          , Ss          , _off^_usr          , Ds          , _off^_usr          , Gg^Em       , _off^_usr          , Gs          , _off^_usr          , Wwg^Ewl     , _off^_usr          , Rb^Em       , _off^_usr          , Ss          , _off^_usr          , _off^_usr          
_off^_usr          , Ss          , 1 Ko        , Chs         , Wwf         , Ds          , Gs^Fms      , Gs^Em       , Gs^Em       , Rb^Tf       , Wwf         , Wwg^Ewl     , Hh^Fms      , Hh          , Ss          , Gs^Fds      , Gs          , Wwg^Ewl     , Wwf         , Ds          , Ds          , Ds^Tf       , Hh          , Ss          , Wwf         , Ds          , Gs^Fmw      , Gs          , Wwf         , Hh          , Ss          , Wwg^Ewf     , Wwf         , Chs         , 2 Ko        , Ss          , _off^_usr          
_off^_usr          , Chs         , Chs         , Chs         , Rb^Em       , Wwf         , Wwf         , Hh^Fp       , Wwf         , Wwf         , Ds          , Gs          , Gs^Em       , Mm          , Wwf         , Gg          , Gs^Em       , Gs^Em       , Wwg^Ewf     , Gs          , Gs^Em       , Mm          , Gg          , Gs^Fds      , Wwf         , Wwf         , Wwf         , Wwf         , Mm          , Wwf         , Wwf         , Wwf         , Ds          , Chs         , Chs         , Chs         , _off^_usr          
_off^_usr          , Wwf         , Gg^Em       , Ss          , Gs^Fds      , Wwg^Ewl     , Ds          , Wwf         , Wwf         , Ds          , Wwf         , Ds^Vd       , Wwf         , Wwf         , Hh          , Gs          , Gs          , Gs          , Ds          , Gs          , Gs^Em       , Hh^Fp       , Gs          , Gg^Em       , Wwf         , Hh^Vd       , Ds          , Wwf         , Wwf         , Wwf         , Gs^Fdw      , Gg          , Gg          , Gs          , Gs          , Wwf         , _off^_usr          
_off^_usr          , Wwf         , Gs^Em       , Gs^Em       , Gg          , Gs          , Ss          , Gs          , Gs          , Wwf         , Wwf         , Wwf         , Gs^Fp       , Wwf         , Wwf         , Ds^Tf       , Wwf         , Wwg^Ewl     , Xu          , Wwg^Ewl     , Wwf         , Gs^Em       , Wwf         , Wwf         , Gs^Em       , Gs^Em       , Rb^Tf       , Ds          , Ss          , Gg          , Gs^Em       , Gg^Em       , Ss          , Gs          , Hh          , Wwf         , _off^_usr          
_off^_usr          , Wwf         , Hh^Fp       , Gs^Em       , Ds          , Ss^Vht      , Gs          , Gs^Em       , Gs^Em       , Co          , Ko          , Co          , Co          , Ds          , Ds          , Wwf         , Xu          , Xu          , Ds          , Xu          , Xu          , Wwf         , Gs^Fds      , Gs^Em       , Co          , Co          , Ko          , Co          , Gg          , Gs^Em       , Gg          , Ss^Vht      , Ss          , Gg          , Wwf         , Wwf         , _off^_usr          
_off^_usr          , Wwf         , Mm          , Gg^Em       , Gs^Em       , Ds^Tf       , Gg^Em       , Gs^Em       , Gs          , Gs          , Ds          , Gs^Fms      , Gg^Em       , Gs          , Gs          , Wwg^Ewl     , Xu          , Wwf         , Urb^Vht     , Wwf         , Xu          , Wwg^Ewf     , Gs          , Gs^Em       , Gs          , Gs          , Gg          , Gs^Fds      , Gs^Em       , Gs^Em       , Mm          , Hh^Fms      , Gs^Em       , Ds^Tf       , Ww^Ewl      , Wwf         , _off^_usr          
_off^_usr          , Wwf         , Gs          , Gs          , Gg          , Gs^Em       , Ss          , Gs          , Hh^Fds      , Gg          , Ss          , Hh          , Gg^Em       , Gs^Em       , Urb         , Rp          , Ur          , Uu          , Ur          , Uu          , Ur^Em       , Rp          , Urb         , Gs^Em       , Gg          , Hh          , Hh^Fp       , Gs          , Gg^Em       , Gg^Em       , Gs          , Gs          , Gs^Em       , Gs^Em       , Gg          , Wwf         , _off^_usr          
_off^_usr          , Wwf         , Wwf         , Gs^Em       , Hh          , Gs          , Gs          , Gs          , Gs          , Ss          , Xu          , Xu          , Xu          , Rp          , Rp          , Rp          , Dd^Dc       , Ur          , Wwr         , Ur^Em       , Uu^Tf       , Rp          , Rp          , Rp          , Xu          , Xu          , Xu          , Ss          , Ss          , Gs^Em       , Gg          , Ss          , Gg          , Gs          , Hh^Fds      , Wwf         , _off^_usr          
_off^_usr          , Hh^Vd       , Wwf         , Co          , Ko          , Co          , Co          , Gs^Em       , Gg          , Xu          , Sm          , Wwf         , Uu          , Ur^Em       , Uu^Tf       , Ko          , Ur          , Ur^Em       , Wwg^Ewf     , Ur          , Ur          , Ko          , Dd^Dc       , Ur^Em       , Uu          , Wwf         , Sm          , Xu          , Ds          , Gg          , Co          , Co          , Ko          , Co          , Wwf         , Wwf         , _off^_usr          
_off^_usr          , Gs          , Gs^Em       , Wwf         , Wwf         , Gs^Fdw      , Wwf         , Gg          , Wog^Bw|     , Xu          , Wwf         , Urb^Vd      , Ur          , Ur^Em       , Ur          , Ur^Em       , Dd^Emf      , Hh          , Wwf         , Gs^Fds      , Dd^Emf      , Ur^Em       , Ur^Em       , Ur^Em       , Ur^Em       , Urb^Vd      , Wwf         , Xu          , Gs^Fmw      , Ds^Vd       , Gs          , Hh          , Gg          , Wwf         , Gs^Fms      , Gg^Em       , _off^_usr          
_off^_usr          , Ds^Tf       , Ss          , Gs^Em       , Wwg^Bw\     , Ss          , Mm          , Wwf         , Wog^Bw|     , Xu          , Xu          , Uu          , Ur          , Wwr         , Wwg^Ewl     , Gs^Fds      , Hh          , Gs^Fet      , Co          , Hh          , Gs^Fet      , Hh          , Wwg^Ewl     , Wwr         , Ur          , Uu          , Xu          , Xu          , Wwg         , Gg          , Gs^Em       , Gs^Em       , Gs^Em       , Wwf         , Gs          , Gg          , _off^_usr          
_off^_usr          , Ss          , Gs^Fms      , Wwg^Ewf     , Gg          , Gg          , Hh^Fp       , Wwg^Ewl     , Gs          , Wog^Bw\     , Rp          , Ur^Em       , Dd^Dc       , Ur          , Hh          , Wwf         , Co          , Co          , Ss          , Co          , Co          , Wwf         , Gs^Fds      , Ur          , Uu^Tf       , Ur          , Rp          , Gg          , Gs          , Sm^Bw/      , Ss          , Gs          , Wog^Bw\     , Wwg^Ewf     , Wog^Bw|     , Rb^Tf       , _off^_usr          
_off^_usr          , Wwg^Ewf     , Hh          , Ds          , Ds^Tf       , Gs^Em       , Gs^Em       , Gs          , Ds          , Gs^Em       , Urb         , Rp          , Ko          , Ur^Em       , Dd^Emf      , Gs^Fet      , Co          , Ss          , Ko          , Ss          , Co          , Hh          , Dd^Emf      , Ur          , Ko          , Rp          , Urb         , Gs^Em       , Ds          , Ds          , Ss          , Ss          , Hh^Fms      , Wog^Bw/     , Ss          , Ss          , _off^_usr          
_off^_usr          , Wwg^Ewl     , Gs^Fds      , Ds          , Gs          , Gg^Em       , Hh^Fds      , Gs^Em       , Gs          , Gs          , Rp          , Rp          , Uu^Tf       , Ur          , Gs^Fds      , Hh          , Co          , Ss          , Ss          , Ss          , Co          , Gs^Fet      , Hh          , Ur^Em       , Dd^Dc       , Rp          , Rp          , Gs          , Gs          , Ds          , Ss          , Ss          , Wog^Bw/     , Wog^Bw\     , Wog^Bw|     , Ss          , _off^_usr          
_off^_usr          , Ss          , Ss          , Wwg^Ewl     , Wwg^Bw/     , Gg          , Mm          , Wwg^Ewl     , Wog^Bw|     , Wog^Bw/     , Xu          , Ur          , Ur^Em       , Ur          , Wwg^Ewf     , Wwf         , Gs^Fet      , Co          , Co          , Co          , Hh          , Wwf         , Wwg^Ewf     , Ur          , Ur          , Ur          , Xu          , Gs          , Wwg         , Sm^Bw\      , Gs          , Gs          , Gg          , Wwg^Ewl     , Gg          , Rb^Tf       , _off^_usr          
_off^_usr          , Rb^Tf       , Gs          , Gs          , Wwf         , Ss          , Wwf         , Wwf         , Wog^Bw|     , Xu          , Wwf         , Uu          , Ur          , Wwr         , Ur          , Hh          , Dd^Emf      , Hh          , Wwf         , Gs^Fet      , Dd^Emf      , Gs^Fds      , Ur          , Wwr         , Ur^Em       , Uu          , Wwf         , Xu          , Gs^Fmw      , Gs          , Gg          , Gs^Em       , Gg          , Wwf         , Gs^Fds      , Gg^Em       , _off^_usr          
_off^_usr          , Gg^Em       , Wwf         , Wwf         , Ko          , Gs^Fms      , Co          , Gg          , Gs^Em       , Xu          , Ds          , Urb^Vd      , Uu          , Ur^Em       , Dd^Dc       , Ur          , Ur          , Gs^Fds      , Wwg^Ewl     , Hh          , Ur^Em       , Ur          , Uu^Tf       , Ur^Em       , Uu          , Urb^Vd      , Ds          , Xu          , Ds          , Ds^Vd       , Co          , Hh          , Ko          , Wwf         , Wwf         , Gg^Em       , _off^_usr          
_off^_usr          , Hh^Vd       , Wwf         , Co          , Hh          , Co          , Gg          , Gs^Em       , Gs          , Xu          , Xu          , Wwf         , Xu          , Ur^Em       , Rp          , Ko          , Uu^Tf       , Ur^Em       , Wwr         , Ur^Em       , Dd^Dc       , Ko          , Rp          , Ur          , Xu          , Wwf         , Xu          , Xu          , Ss          , Gg          , Gg          , Co          , Gg          , Co          , Hh^Fms      , Wwf         , _off^_usr          
_off^_usr          , Wwf         , Gg          , Gs          , Gs          , Gg          , Ss          , Gg          , Hh^Fp       , Ss          , Ss          , Xu          , Gs          , Rp          , Urb         , Rp          , Ur          , Ur          , Ur          , Ur^Em       , Ur          , Rp          , Urb         , Rp          , Gs^Em       , Xu          , Hh^Fms      , Ss          , Gs          , Gs          , Gs          , Ss          , Gs          , Gs^Em       , Gs^Em       , Wwf         , _off^_usr          
_off^_usr          , Wwf         , Mm          , Gs^Em       , Gs^Em       , Gs^Em       , Gs^Em       , Gg          , Gs          , Gg^Em       , Ds          , Hh          , Gs          , Gs^Em       , Gs^Em       , Rp          , Xu          , Uu          , Urb^Vht     , Uu          , Xu          , Rp          , Gg          , Gs          , Gs          , Hh          , Gs          , Gg          , Gs^Em       , Gg^Em       , Mm          , Gs          , Gs          , Gs^Em       , Ww^Ewf      , Wwf         , _off^_usr          
_off^_usr          , Wwf         , Hh^Fms      , Gg          , Ds          , Ds^Tf       , Gs^Em       , Gs^Em       , Gs          , Gs          , Ko          , Gs^Fdw      , Co          , Gg          , Ds          , Wwg^Ewl     , Xu          , Wwf         , Sm          , Wwf         , Xu          , Wwg^Ewl     , Gs^Fds      , Gs          , Co          , Gs          , Ko          , Gs^Fp       , Gs          , Gs^Em       , Gs          , Hh^Fms      , Ss          , Rb^Tf       , Wwf         , Wwf         , _off^_usr          
_off^_usr          , Wwf         , Gs          , Gs          , Gg          , Ss^Vht      , Ss          , Gs^Em       , Gg          , Co          , Wwf         , Co          , Gs^Fds      , Ds          , Wwf         , Wwf         , Wwf         , Xu          , Xu          , Xu          , Wwf         , Wwf         , Wwf         , Gs          , Gs^Em       , Co          , Rb^Tf       , Co          , Ss          , Gg^Em       , Gs^Em       , Ss^Vht      , Ss          , Gg^Em       , Hh          , Wwf         , _off^_usr          
_off^_usr          , Wwf         , Gg          , Gs^Em       , Gs^Fds      , Gs          , Ds          , Gs          , Wwf         , Wwf         , Wwf         , Wwf         , Wwf         , Wwf         , Hh          , Rb^Tf       , Gg          , Wwg^Ewl     , Ds          , Wwg^Ewf     , Gg          , Gg          , Gs^Em       , Wwf         , Wwf         , Gs^Em       , Ds          , Ds          , Wwf         , Gs          , Gs^Fdw      , Gg^Em       , Gs          , Gg^Em       , Gg^Em       , Wwf         , _off^_usr          
_off^_usr          , Wwf         , Chs         , Ss          , Rb^Em       , Wwg^Ewl     , Wwf         , Wwf         , Wwf         , Ds          , Ds          , Ds^Vd       , Gs^Em       , Wwf         , Wwf         , Gs          , Gs^Em       , Gs^Em       , Wwg^Ewl     , Gs          , Gs^Em       , Hh^Fms      , Gs          , Gs^Em       , Wwf         , Hh^Vd       , Wwf         , Wwf         , Mm          , Wwf         , Wwf         , Gs^Em       , Ds          , Gs          , Chs         , Wwf         , _off^_usr          
_off^_usr          , Chs         , 3 Ko        , Chs         , Wwf         , Wwf         , Gs^Fp       , Hh^Fp       , Gg          , Wwf         , Wwf         , Gs          , Hh^Fp       , Mm          , Ss          , Gg          , Gs          , Gs          , Wwf         , Gs          , Ds          , Mm          , Hh          , Gs^Fms      , Wwf         , Wwf         , Gs^Fds      , Wwf         , Wwf         , Wwf         , Ss          , Wwf         , Wwf         , Chs         , 4 Ko        , Chs         , _off^_usr          
_off^_usr          , Ss          , Ss          , Chs         , Hh          , Ds          , Gg          , Gs^Em       , Gs          , Ds^Tf       , Ss          , Wwg^Ewf     , Wwg^Ewl     , Hh          , Gs^Em       , Gs^Fms      , Wwg^Ewf     , Wwg^Ewl     , Wwf         , Ds          , Gs^Fdw      , Ds^Tf       , Ss          , Ss          , Gs          , Gs          , Gs^Em       , Ds          , Ds          , Hh          , Wwg^Ewf     , Wwg^Ewl     , Rb^Em       , Chs         , Ss          , Ss          , _off^_usr          
_off^_usr          , _off^_usr          , _off^_usr          , _off^_usr          , _off^_usr          , _off^_usr          , _off^_usr          , _off^_usr          , _off^_usr          , _off^_usr          , _off^_usr          , _off^_usr          , _off^_usr          , _off^_usr          , _off^_usr          , _off^_usr          , _off^_usr          , _off^_usr          , _off^_usr          , _off^_usr          , _off^_usr          , _off^_usr          , _off^_usr          , _off^_usr          , _off^_usr          , _off^_usr          , _off^_usr          , _off^_usr          , _off^_usr          , _off^_usr          , _off^_usr          , _off^_usr          , _off^_usr          , _off^_usr          , _off^_usr          , _off^_usr          , _off^_usr          
