Ur, Xuc, Xuc, Xuc, Xuc, Xuc, Xuc, Xuc, Xuc, Xuc, Xuc, Xuc, Xuc, Xuc, Xuc, Xuc, Xuc, Xuc, Xuc, Xuc, Xuc, Xuc, Xuc, Xuc, Xuc, Xuc, Xuc, Xuc, Xuc, Xuc, Ur
Xuc, Uu, Uu^Vud, Xuc, 1 Kud, Cud, Uh, Xuc, Uu^Tf, Xuc, Uh, Xuc, Uu, Uu, Isa, Xuc, Isa, Uu, Uu, Xuc, Uh, Xuc, Uu^Tf, Xuc, Uh, Cud, 7 Kud, Xuc, Uu^Vud, Uu, Xuc
Xuc, Xuc, Isa, Cud, Cud, Cud, Isa, Uu^Tf, Uu^Vu, Isa, Isa, Isa, Uu, Isa, Uu, Uu, Uu, Isa, Uu, Isa, Isa, Isa, Uu^Vu, Uu^Tf, Isa, Cud, Cud, Cud, Isa, Xuc, Xuc
Xuc, Uu^Vu, Isa, Uu, Isa, Isa, Uu, Isa, Isa, Isa, Uh^Ii, Uu, Isa, Uu^Ii, Qxu, Xuc, Qxu, Uu^Ii, Isa, Uu, Uh^Ii, Isa, Isa, Isa, Uu, Isa, Isa, Uu, Isa, Uu^Vu, Xuc
Xuc, Uu, Isa, Uu, Isa, Uu^Tfi, Wwg^Ii, Uu, Isa, Uu, Uu, Uu^Tf, Uu, Qxu, Uu, Xuc, Uu, Qxu, Uu, Uu^Tf, Uu, Uu, Isa, Uu, Wwg^Ii, Uu^Tfi, Isa, Uu, Isa, Uu, Xuc
Xuc, Xuc, Isa, Isa, Wwg, Wwg^Ii, Uu, Uu, Uh, Isa, Isa, Isa, Xuc^Efs, Uu, Uh, Uh, Uh, Uu, Xuc^Efs, Isa, Isa, Isa, Uh, Uu, Uu, Wwg^Ii, Wwg, Isa, Isa, Xuc, Xuc
Xuc, Xuc, Xuc, Isa, Uu, Uu, Uu, Uh, Xuc, Uu, Isa, Uu, Uu, Uu, Uu, Xuc, Uu, Uu, Uu, Uu, Isa, Uu, Xuc, Uh, Uu, Uu, Uu, Isa, Xuc, Xuc, Xuc
Xuc, Xuc, Uh, Uu, Isa, Xuc^Efs, Uu, Xuc, Xuc, Xuc^Efs, Isa, Isa, Uu, Qxu, Qxu, Xuc, Qxu, Qxu, Uu, Isa, Isa, Xuc^Efs, Xuc, Xuc, Uu, Xuc^Efs, Isa, Uu, Uh, Xuc, Xuc
Xuc, Xuc, Uu, Xuc, Isa, Isa, Uh, Uh, Uu, Uu, Isa, Uu^Ii, Cud, Uu, Xuc, Xuc, Xuc, Uu, Cud, Uu^Ii, Isa, Uu, Uu, Uh, Uh, Isa, Isa, Xuc, Uu, Xuc, Xuc
Xuc, Xuc, Uu, Xuc, Isa, Isa^Ii, Isa, Uu, Cud, Cud, Isa, Isa, Uu, Cud, Xuc, Xuc, Xuc, Cud, Uu, Isa, Isa, Cud, Cud, Uu, Isa, Isa^Ii, Isa, Xuc, Uu, Xuc, Xuc
Xuc, Uh, Uu, Xuc, Uu^Vud, Isa, Uu, Isa, Isa, Uu, Uu, Isa, Uu, Uu, Uu, Xuc, Uu, Uu, Uu, Isa, Uu, Uu, Isa, Isa, Uu, Isa, Uu^Vud, Xuc, Uu, Uh, Xuc
Xuc, Xuc, Uu^Tf, Xuc^Efs, Xuc, Isa, Isa, Uu^Tf, Uu, Isa, Cud, Isa, Uu, Uu^Vud, Uu, Uh, Uu, Uu^Vud, Uu, Isa, Cud, Isa, Uu, Uu^Tf, Isa, Isa, Xuc, Xuc^Efs, Uu^Tf, Xuc, Xuc
Xuc, Uu, Uu^Tf, Uu^Tfi, Uu, Cud, Uu, Isa, Isa, Cud, 8 Kud, Isa, Isa, Isa, Isa, Xor, Isa, Isa, Isa, Isa, 2 Kud, Cud, Isa, Isa, Uu, Cud, Uu, Uu^Tfi, Uu^Tf, Uu, Xuc
Xuc, Xuc, Uu, Uu, Uu, Cud, Isa, Isa, Uu, Cud, Isa, Isa, Xor^Efs, Xor, Xor, Isa, Xor, Xor, Xor^Efs, Isa, Isa, Cud, Uu, Isa, Isa, Cud, Uu, Uu, Uu, Xuc, Xuc
Xuc, Uu^Vu, Xuc, Xuc, Xuc, Cud, Xuc, Uu, Uu, Uu^Vud, Uu, Isa, Isa, Xor, Isa, Isa, Isa, Xor, Isa, Isa, Uu, Uu^Vud, Uu, Uu, Xuc, Cud, Xuc, Xuc, Xuc, Uu^Vu, Xuc
Xuc, Xuc, Xuc, Xuc, Xuc, Xuc, Xuc, Xuc, Uu, Uu, Uu, Isa, Isa, Isa, Xor, Xor, Xor, Isa, Isa, Isa, Uu, Uu, Uu, Xuc, Xuc, Xuc, Xuc, Xuc, Xuc, Xuc, Xuc
Xuc, Xuc, Xuc, Xuc, Xuc, Xuc, Xuc, Xuc^Efs, Uu, Uu, Uu, Isa, Isa, Isa, Isa, Xor, Isa, Isa, Isa, Isa, Uu, Uu, Uu, Xuc^Efs, Xuc, Xuc, Xuc, Xuc, Xuc, Xuc, Xuc
Xuc, Uu^Vu, Uu, Xuc, Uu, Cud, Isa, Uu, Uu, Uu^Vud, Isa, Isa, Xor^Efs, Xor, Xor, Isa, Xor, Xor, Xor^Efs, Isa, Isa, Uu^Vud, Uu, Uu, Isa, Cud, Uu, Xuc, Uu, Uu^Vu, Xuc
Xuc, Xuc, Uu^Tf, Uu, Uu, Cud, Uu, Isa, Isa, Cud, 3 Kud, Isa, Isa, Xor, Isa, Isa, Isa, Xor, Isa, Isa, 5 Kud, Cud, Isa, Isa, Uu, Cud, Uu, Uu, Uu^Tf, Xuc, Xuc
Xuc, Uu, Uu^Tf, Uu^Tfi, Xuc, Cud, Isa, Isa, Uu, Cud, Cud, Isa, Uu, Isa, Uu, Xor, Uu, Isa, Uu, Isa, Cud, Cud, Uu, Isa, Isa, Cud, Xuc, Uu^Tfi, Uu^Tf, Uu, Xuc
Xuc, Xuc, Uu, Xuc, Uu^Vud, Isa, Uu, Uu^Tf, Isa, Isa, Uu, Isa, Uu, Uu^Vud, Uu, Uh, Uu, Uu^Vud, Uu, Isa, Uu, Isa, Isa, Uu^Tf, Uu, Isa, Uu^Vud, Xuc, Uu, Xuc, Xuc
Xuc, Uh, Uu, Xuc, Isa, Isa, Isa, Isa, Cud, Uu, Isa, Isa, Uu, Uu, Xuc, Xuc, Xuc, Uu, Uu, Isa, Isa, Uu, Cud, Isa, Isa, Isa, Isa, Xuc, Uu, Uh, Xuc
Xuc, Xuc, Uu, Xuc, Isa, Isa^Ii, Uh, Uu, Uu, Cud, Isa, Isa, Cud, Cud, Xuc, Xuc, Xuc, Cud, Cud, Isa, Isa, Cud, Uu, Uu, Uh, Isa^Ii, Isa, Xuc, Uu, Xuc, Xuc
Xuc, Xuc, Uh, Xuc, Isa, Isa, Uu, Uh, Xuc, Uu, Isa, Uu^Ii, Uu, Uu, Qxu, Xuc, Qxu, Uu, Uu, Uu^Ii, Isa, Uu, Xuc, Uh, Uu, Isa, Isa, Xuc, Uh, Xuc, Xuc
Xuc, Xuc, Xuc^Efs, Uu, Uu, Xuc^Efs, Uu, Xuc, Xuc, Xuc^Efs, Isa, Isa, Uu, Qxu, Uu, Xuc, Uu, Qxu, Uu, Isa, Isa, Xuc^Efs, Xuc, Xuc, Uu, Xuc^Efs, Uu, Uu, Xuc^Efs, Xuc, Xuc
Xuc, Xuc, Isa, Isa, Wwg, Uu, Uu, Uh, Uh, Uu, Isa, Uu, Xuc^Efs, Uu, Uh, Xuc, Uh, Uu, Xuc^Efs, Uu, Isa, Uu, Uh, Uh, Uu, Uu, Wwg, Isa, Isa, Xuc, Xuc
Xuc, Xuc, Isa, Isa, Isa, Wwg^Ii, Wwg^Ii, Uu, Isa, Isa, Uu, Isa, Uu, Uu, Uu, Uh, Uu, Uu, Uu, Isa, Uu, Isa, Isa, Uu, Wwg^Ii, Wwg^Ii, Isa, Isa, Isa, Xuc, Xuc
Xuc, Uu, Isa, Uu, Isa, Uu^Tfi, Uu, Uu, Isa, Uu, Uh^Ii, Uu^Tf, Ur, Qxu, Qxu, Xuc, Qxu, Qxu, Ur, Uu^Tf, Uh^Ii, Uu, Isa, Uu, Uu, Uu^Tfi, Isa, Uu, Isa, Uu, Xuc
Xuc, Uu^Vu, Isa, Uu, Cud, Isa, Isa, Isa, Uu^Vu, Isa, Isa, Uu, Uu, Uu^Ii, Uu, Xuc, Uu, Uu^Ii, Uu, Uu, Isa, Isa, Uu^Vu, Isa, Isa, Isa, Cud, Uu, Isa, Uu^Vu, Xuc
Xuc, Xuc, Uu^Vud, Cud, 6 Kud, Cud, Uh, Uu^Tf, Uu^Tf, Isa, Uh, Isa, Uu, Ur, Ur, Uu, Ur, Ur, Uu, Isa, Uh, Isa, Uu^Tf, Uu^Tf, Uh, Cud, 4 Kud, Cud, Uu^Vud, Xuc, Xuc
Ur, Uu, Xuc, Xuc, Xuc, Cud, Xuc, Xuc, Xuc, Xuc, Xuc, Xuc, Xuc, Uu, Xuc, Xuc, Xuc, Uu, Xuc, Xuc, Xuc, Xuc, Xuc, Xuc, Xuc, Cud, Xuc, Xuc, Xuc, Uu, Ur
Xuc, Xuc, Xuc, Xuc, Xuc, Xuc, Xuc, Xuc, Xuc, Xuc, Xuc, Xuc, Xuc, Xuc, Xuc, Xuc, Xuc, Xuc, Xuc, Xuc, Xuc, Xuc, Xuc, Xuc, Xuc, Xuc, Xuc, Xuc, Xuc, Xuc, Xuc
