Wo, Wo, Wo, Wo, Wo, Wo, Wo, Wo, Wo, Wo, Wo, Wo, Wo, Wo, Wo, Wo, Wo, Wo, Wo, Wo, Wo, Wo, Wo, Wo, Wo, Wo, Wo, Wo, Wo, Wo, Wo, Wo, Wo, Wo, Wo, Wo, Wo, Wo, Wo, Wo, Wo, Wo, Wo, Wo, Wo, Wo, Wo, Wo, Wo, Wo
Wo, Wo, Wo, Wo, Wo, Wo, Wo, Wo, Wo, Wo, Wo, Wo, Wo, Wo, Wo, Wo, Wo, Wo, Wo, Wo, Wo, Wo, Wo, Wo, Wo, Wo, Wo, Wo, Wo, Wo, Wo, Wo, Wo, Wo, Wo, Wo, Wo, Wo, Wo, Wo, Wo, Wo, Wo, Wo, Wo, Wo, Wo, Wo, Wo, Wo
Wo, Wo, Wo, Wo, Wo, Wo, Wo, Wo, Wo, Wo, Wo, Wo, Wo, Wo, Wo, Wo, Wo, Wo, Wo, Wo, Wo, Wo, Wo, Wo, Ds, Ds, Ds^Vct, Ds, Ds, Wo, Wo, Wo, Wo, Wo, Wo, Wo, Wo, Wo, Wo, Wo, Wo, Wo, Wo, Wo, Wo, Wo, Wo, Wo, Wo, Wo
Wo, Wo, Wo, Wo, Wog, Wot, Wo, Wo, Wot, Wo, Wog, Wog, Wo, Wog, Wo, Wog, Wot, Wog, Wog, Wot, Ww, Ww, Uu, Wo, Wo, Gg^Fp, Rd^Fdw, Gd^Fmw, Gg^Fp, Ds, Ds, Wo, Wo, Wo, Wo, Wog, Wo, Wog, Wog, Wot, Wo, Wot, Wot, Wo, Wot, Wog, Wo, Wo, Wo, Wo
Wo, Wo, Wo, Wo, Wot, Wot, Wot, Wo, Wot, Wog, Wog, Wot, Wog, Wot, Wo, Wog, Wot, Wwt, Wwg, Dd, Gd, Dd, Uu, Gg^Fp, Wo, Ch, Ch, 7 Kh, Ch, Ch, Wo, Wo, Wo, Wot, Wot, Wot, Wo, Wo, Wo, Wog, Wo, Wot, Wot, Wo, Wo, Wog, Wo, Wo, Wo, Wo
Wo, Wo, Wo, Wo, Wog, Wog, Wot, Wo, Wo, Wo, Wo, Wog, Wog, Wot, Wog, Re^Vh, Gd, Gd, Uu, Gd^Vo, Dd, Dd, Rd, Gg^Fp, Gg^Fp, Ww, Ww, Ch, Wwf, Ww, Ww, Wo, Wo, Wo, Wo, Wog, Wo, Wwt, Wot, Wo, Wog, Wot, Wog, Wot, Wot, Wo, Wo, Wo, Wo, Wo
Wo, Wo, Wo, Wo, Wot, Wot, Wog, Wo, Wog, Wog, Wot, Wot, Wo, Wot, Ch, Ch, Ch, Gd^Fmw, Gd, Gg, Gd, Gg, Gd, Gd, Gd^Fmw, Hh, Gg, Wwf, Rd, Rd, Rd, Gg, Gg, Wo, Ww, Wwt, Ww, Ww, Wog, Wot, Wot, Wot, Wot, Wot, Wog, Wot, Wo, Wo, Wo, Wo
Wo, Wo, Wo, Wo, Wo, Wo, Wo, Wot, Wo, Wot, Wot, Wo, Ww, Gd, Ch, 6 Kh, Ch, Gg^Fp, Gd, Gd, Gg, Gg, Gd, Rd, Gg^Fp, Hh, Hh, Gg, Rp, Rd^Fdw, Rp, Rr, Rrc, Gg, Uu, Uu, Re^Vh, Wwg, Wot, Wot, Wo, Wot, Wo, Wot, Wo, Wog, Wo, Wo, Wo, Wo
Wo, Wo, Wo, Wo, Wot, Wot, Wot, Wot, Wo, Wot, Ww^Vm, Wwg, Uu, Gd^Fmw, Rd^Fdw, Rd^Fdw, Hh, Hd, Hd, Gd, Gd, Gd, Gg, Gd, Gd, Hh^Vo, Hd, Hh, Hd, Rp, Gg^Fp, Gd^Vhr, Gd, Rp, Gd, Uu, Rd, Wwg, Wo, Wot, Wot, Wo, Wog, Wo, Wot, Wog, Wo, Wo, Wo, Wo
Wo, Wo, Wo, Wo, Wog, Wot, Wo, Wot, Wog, Wo, Uu, Uu, Rd^Fdw, Gg, Gg^Fp, Gg, Hd, Hd, Hh, Gg, Rd, Gg, Gd, Rd, Rd, Hh, Hd, Rb, Hd, Uh, Gg^Fp, Gg, Gd, Rp, Gg, Dd, Uu, Ww, Wot, Wot, Wo, Wot, Wot, Wo, Wot, Wot, Wo, Wo, Wo, Wo
Wo, Wo, Wo, Wo, Wog, Wot, Wot, Wot, Wog, Wog, Dd, Rd, Gd, Gg, Gd, Gd, Mm, Hd, Hd, Gg, Rd, Gd, Rd, Rd, Gd, Gg, Hd, Hh, Rb, Hd, Uh, Rd, Gg, Rp, Gd, Dd, Dd, Rd, Wwg, Chw, Chw, Chw, Ww, Ww, Wot, Wog, Wo, Wo, Wo, Wo
Wo, Wo, Wo, Wo, Wog, Wog, Wo, Wwt, Ww, Dd, Gg, Gd, Gd, Gd, Rd, Rd, Hh, Hd, Gg, Rd, Gd, Rd, Gg, Gd, Gg, Gd, Gd, Gg^Fp, Hh, Hh^Vd, Uh, Gg, Gd, Rr, Rp, Qxe, Rd, Uu, Uu, Chr, 2 Khw, Chw, Gd, Wwt, Wo, Wo, Wo, Wo, Wo, Wo
Wo, Wo, Wo, Wo, Wot, Ww, Dd, Re^Vh, Dd, Dd, Dd, Gg, Gd, Gd, Gg, Gg, Rd, Gd^Vo, Gd, Gg, Gg, Rd, Gd, Gd, Gs, Gg, Rd, Gg^Fp, Rd^Fdw, Hh, Hh, Gg, Rd, Gg, Qxe, Qxe, Rrc, Dd, Dd, Rrc, Uu, Uu, Uu, Uu, Wo, Wo, Wo, Wo, Wo, Wo
Wo, Wo, Wo, Wo, Wwt, Rd, Dd, Rd, Gd, Gd, Gd, Rd, Gg, Rd, Gg, Gg, Gg, Rd^Fdw, Gg^Fp, Gd, Rd, Rd, Gg, Gs, Gg, Gd, Gd, Gd, Gd, Rd, Hd, Gd, Gd, Qxe, Gd, Rd, Gd, Rrc, Rp, Rp, Gd, Gg, Uu, Gg, Wwg, Wo, Wo, Wo, Wo, Wo
Wo, Wo, Wo, Wo, Ww, Gg, Rd, Gg, Gg, Rd, Rd, Gd, Rd, Dd, Gg, Rd, Gg, Gg, Gd, Gg, Rd, Gd, Gd, Gg, Gd, Gd, Gg, Gg^Fp, Rd, Gg, Gd, Rd, Rd, Qxe, Rd, Rd, Rd, Gg, Gd^Vc, Rrc, Rd, Gd, Uu, Uu, Re^Vh, Wwg, Wo, Wo, Wo, Wo
Wo, Wo, Wo, Wo, Ww, Dd, Gg, Rd, Gd, Gd, Gg, Gg, Wwt, Re^Vh, Ww, Rd, Gd, Rd, Gd, Rd, Rd, Gd, Gg, Gg, Gd, Rd^Do, Gg, Gg, Gd, Rd, Gd, Rd, Gd, Rd, Gg, Rd, Gg, Gg, Gd, Rrc, Gg, Gd, Gd, Dd, Gd, Wwt, Wo, Wo, Wo, Wo
Wo, Wo, Wo, Wo, Ww, Uu, Gd, Rd, Gg, Rd, Wwt, Wwt, Wwg, Wwg, Ww, Wwt, Rd, Gd, Gd, Gg, Rd, Gg, Hd, Uh, Gd, Rd, Rd, Rd, Gd, Gd, Rd, Gg, Rd, Gd, Rd, Gg, Rd, Gg, Rd, Rr, Gd, Gg, Dd, Dd, Gg, Rd, Wo, Wo, Wo, Wo
Wo, Wo, Wo, Wo, Wwg, Rd, Dd, Dd, Wwg, Ww, Uu, Dd, Gd, Wwg, Ww, Gd, Gg, Rd, Gg, Gg, Uh, Hh, Mm, Hd, Mm, Rd, Gg, Gg, Gg, Rd, Gd, Gd, Gd, Gd, Rd, Gd, Gg, Gg, Gg, Rr, Gd, Gg, Gg, Rd, Ds, Ds, Wo, Wo, Wo, Wo
Wo, Wo, Wo, Wo, Wog, Hd^Do, Wwg, Chw, Chr, Chr, Dd^Vda, Rd, Gd, Gg, Wwt, Gg, Rd, Gg, Gs, Uh, Mm, Mm, Wog, Mm, Wog, Mm, Hh, Gg^Fp, Rd^Fdw, Gd^Fmw, Rd, Gd, Gg, Gd, Rd, Uh, Hh, Hh, Gg, Rr, Gd, Rd, Rd, Gg, Dd, Dd, Wo, Wo, Wo, Wo
Wo, Wo, Wo, Wo, Wog, Wwt, Uu, Chr, 8 Khr, Rd, Dd, Dd, Dd, Dd, Uu, Wwg, Wwg, Rd, Hh, Hh, Mm, Wwg^Dr, Mm, Wog, Hh, Mm, Hh, Gd^Vhr, Gd^Fmw, Rd^Fdw, Gg^Fp, Gd, Rd, Gd, Uh, Uh, Wo, Uh, Hd, Rrc, Gg, Gg, Gd^Do, Gd, Wwg, Wwg, Ds, Wo, Wo, Wo
Wo, Wo, Wo, Wo, Ww, Uu, Dd, Chr, Rd^Fdw, Rd^Fdw, Gg^Fp, Gg, Gd, Gd, Gd, Ww, Wwg, Gd^Vc, Gg, Uh, Hh, Mm, Wog, Wog, Mm, Mm, Uh, Rd^Fdw, Gg^Fp, Gd^Fmw, Gd^Fmw, Gd, Gd, Gg, Hh, Wo, Hd, Uh, Gd^Vc, Rrc, Rd, Gg, Gd, Gd, Wwg, Gd, Ds, Wo, Wo, Wo
Wo, Wo, Wo, Ds, Uu, Rd, Gg, Rrc, Gg, Rd^Fdw, Gd, Gg, Gg, Gg, Wwg, Wwg, Wog, Ww, Gg^Fp, Hd, Hh, Hh, Wog, Mm, Hh, Uh, Uh, Gd^Fmw, Gd^Ve, Gd^Fmw, Gd^Fmw, Gd, Gg, Rd, Gg, Hh, Uh, Rd, Rd^Fdw, Rrc, Rd, Rd, Wwg, Wwg, Gd, Gd, Ds, Ds, Wo, Wo
Wo, Wo, Wo, Ds, Gd, Gg, Gg, Rrc, Gd, Gd, Gd, Gd, Gd, Ww, Wwg, Wog, Wo, Ww, Wwt, Hd, Gg^Fp, Wwg, Hd, Hd, Gg, Gd, Rd, Gd^Fmw, Gg^Fp, Gg^Fp, Gg, Gg, Rd, Gg, Gd, Gd, Rd, Rd, Gg, Rrc, Gd, Gd, Wwrg, Wwg, Ds, Rd, Wo, Wo, Wo, Wo
Wo, Wo, Wo, Ds, Dd, Gd, Gd, Rp, Gd, Gg^Fp, Gd^Fmw, Uh, Mm, Mm, Wwt, Wog, Wo, Wot, Ww, Gd, Wwg, Wwg, Gg, Rd, Gd, Gd, Cv, Gg, Gd^Fmw, Gd^Fmw, Rd^Fdw, Gg, Gd, Rd, Rd, Gd, Rd, Rd, Gd, Rr, Gg, Uu, Wwrg, Wwg, Ds^Vu, Ds, Wo, Wo^Dr, Wo, Wo
Wo, Wo, Wo, Wo, Uu, Gd, Rrc, Rp, Rd^Fdw, Gd^Fmw, Hh, Mm, Mm, Wwt, Ww, Wot, Wog, Wot, Wwg, Wwg, Gg, Gd^Fmw, Gd, Cv, Cv, 1 Kv, Rd, Rd, Gd, Gg^Fp, Gg^Fp, Gg, Rd, Rd, Rd, Rd, Gg, Rd, Rrc, Rr, Ch, Rd, Gg, Wwg, Ww, Ww, Wo, Wo, Wo, Wo
Wo, Wo, Ds, Ds, Uu, Gd, Rp, Rd, Gd^Fmw, Gd^Fmw, Hh, Mm, Mm, Hh^Vhhr, Wwt, Wot, Wwt, Wwg, Ww, Hh, Gd, Rd, Rd, Gd, Gg, Cv, Cv, Gg, Rd, Rd^Fdw, Rd^Fdw, Uu, Dd, Dd, Gd, Dd, Uu, Rrc, Rd, Ch, 5 Kh, Ch, Rd, Ww, Ww, Ww, Ds, Wo, Wo, Wo
Wo, Wo, Wo, Ds, Uu, Rd, Rr, Dd, Rd^Fdw, Gd^Fmw, Hh, Mm, Mm, Hh, Gs, Wwg, Wwt, Mm, Mm, Hh, Hd, Rd, Rd^Fdw, Rd^Fdw, Rd, Gd, Gd, Uu, Dd, Dd, Uu, Uu, Gg, Rd, Gd, Gg, Rp, Rp, Rr, Ch, Ch, Rd, Rd, Gg, Dd, Gg, Ds, Ds, Wo, Wo
Wo, Wo, Wo, Ds, Dd, Dd, Rr, Dd, Rd^Fdw, Gd^Fmw, Uh, Mm, Mm, Hh, Hh, Gs, Wwt, Gs, Hh, Mm, Hh, Hd, Gg, Gg^Fp, Gd, Dd, Dd, Uu, Dd, Uu, Gg, Dd, Uu, Dd, Rp, Gd^Vc, Rr, Rd, Gg, Rp, Gg, Gd, Gd, Gd, Uu, Uu, Ds, Ds, Wo, Wo
Wo, Wo, Wo, Wo, Wwt, Dd, Rrc, Rd, Gg, Gd, Hh, Uh, Uh, Mm, Mm, Hh, Hh, Gs, Mm, Mm^Xm, Mm, Hd, Gd^Fmw, Gg, Gg, Uu, Rp, Rd, Re, Uu, Gg, Gg, Rp, Rr, Gg, Rrc, Gg, Gd, Gg, Rd, Rd, Gd^Vc, Gg, Rd, Rd, Uu, Ds, Wo, Dd^Do, Wo
Wo, Wo, Wo, Wo, Ww, Re^Vh, Rrc, Rd, Rd^Fdw, Rd, Hh, Hh, Gs, Hhd, Hhd, Mm, Mm, Mm, Mm, Mm, Hh, Uh, Gd^Vd, Rd^Fdw, Rd, Gg, Re, Re, Rp^Vhcr, Rd, Rp, Rr, Rrc, Gd, Rd, Gg, Hh, Uh, Rd, Gd, Gg, Gd, Gg, Rd^Fdw, Dd, Dd, Wo, Wo, Wo, Wo
Wo, Wo, Wo, Wo, Wwt, Uu, Rr, Gd^Fmw, Gd^Fmw, Gd^Fmw, Gg^Fp, Uh, Hh, Hd, Uh, Gs, Hh, Mm, Mm, Mm, Mm, Gg, Gd^Fmw, Gd, Gd, Gg, Dd, Rd, Gd, Rp, Gd, Gd, Rrc, Gd, Gd, Hh, Hh, Hh, Gg, Hd, Gd, Gg, Rd, Gd^Fmw, Dd, Rd, Ds, Wo, Wo, Wo
Wo, Wo, Wo, Wo, Wwt, Uu, Dd, Rp, Rr, Rd, Rd, Gd, Gd, Gg, Uh, Hh, Uh, Uh, Gs, Mm, Hh, Gg, Rd, Gd, Gd, Gd, Rd, Gg, Gg, Gg, Rd, Gd, Rr, Gd, Hd, Hd, Mv, Hd, Hh, Uh, Uh, Rd, Rd, Gg, Gg^Fp, Uu, Ds, Wo, Wo, Wo
Wo, Wo, Wo, Wo, Ww, Rd, Dd, Dd, Rd, Rr, Gd, Rd, Gd, Gg^Fp, Gg, Hd, Hh, Gs, Hh, Hh, Uh, Rd, Rd, Gg, Dd, Rd, Gd, Rd, Rd, Gs, Rd, Hh, Rrc, Hd, Uh, Mm, Mm, Mm, Hd, Mm, Hd, Gd, Gg, Rd, Gd, Dd^Do, Wo, Wo, Wo, Wo
Wo, Wo, Wo, Wo, Wwg, Rp^Vhcr, Dd, Uu, Gg, Rrc, Rr, Rd, Rd, Rd^Fdw, Gd^Fmw, Gd^Fmw, Hh, Uh, Uh, Hd, Gg, Gg, Gg, Gg, Gd, Gd, Gg, Gd, Gd, Rd, Uh, Hd, Rp, Rd, Uh, Hd, Uh, Uh, Hd, Hd, Hh, Gg, Gg, Gd, Gd, Gd, Wo, Wo, Wo, Wo
Wo, Wo, Wo, Wo, Wog, Wwg, Gg, Uu, Gg, Uu, Rrc, Gd^Vc, Gd, Rd, Gd^Fmw, Gd, Gd, Rd, Rd, Gd, Gg, Gg, Gd, Rd, Rd, Gg, Gd, Gg, Rd, Uh, Hd, Hd, Rr, Rd, Uh, Uh, Rd, Gg, Hd, Gd, Gg^Fp, Gg^Fp, Rd^Fdw, Gd, Gd, Ww, Wo, Wo, Wo, Wo
Wo, Wo, Wo, Wo, Wo, Wo, Wwg, Ch, Ch, Ch, Gd, Rrc, Gd, Rd, Rrc, Rp, Rp, Rd, Rp, Rd, Gg, Rd, Rd^Vo, Gd, Rrc, Rd, Gd, Rd, Hh, Uh, Uh, Hh, Rrc, Gg, Gd, Rd, Gd, Gg, Rd^Fdw, Rd^Fdw, Gg^Fp, Gd^Ve, Gd^Fmw, Gd, Uu, Wwg, Wo, Wo, Wo, Wo
Wo, Wo, Wo, Wo, Wot, Wog, Ww, Ch, 4 Kh, Ch, Uu, Rp, Rr, Rrc, Gd, Rd, Dd, Rrc, Gg, Rr, Rp, Gd, Rr, Rrc, Gd, Rr, Rp, Uh, Rr, Gg, Rr, Gd^Vc, Rrc, Rd, Gd, Gd, Gg, Gd^Ve, Gg^Fp, Gd, Rd, Rd^Fdw, Uu, Rd, Uu, Wwg, Wo, Wo, Wo, Wo
Wo, Wo, Wo, Wo, Wo, Wo, Wwt, Uu, Uu, Rr, Rr, Rp, Gd, Gg, Rd, Rd, Hd, Dd, Uu, Dd, Dd, Rr, Gg, Gg, Uh, Hd, Uh, Rp, Gd, Rp, Rd, Rr, Rrc, Gd, Gg, Gd, Gd, Rd^Fdw, Gg^Fp, Gg^Fp, Rd^Fdw, Dd, Uu, Dd, Wwt, Wog, Wo, Wo, Wo, Wo
Wo, Wo, Wo, Wo, Wo, Wo, Ww, Dd, Uu, Uu, Dd, Dd, Gg, Gd, Hhd, Md^Xm, Hhd, Uu, Dd, Gg, Gs, Gd, Gd, Rd, Hd, Hh, Hh, Rd, Gg, Rd, Rd, Rd, Rp, Gg, Ch, Ch, Ch, Gd, Gd^Fmw, Gd^Fmw, Gg, Wwg, Wwt, Wwg, Wot, Wog, Wo, Wo, Wo, Wo
Wo, Wo, Wo, Wo, Wo, Wot, Ww, Uu, Ur^Do, Dd, Uu, Gd, Dd, Hhd, Md^Xm, Md^Xm, Hhd, Gg, Gg, Chr, 9 Khr, Chr, Gd, Rd, Uh, Hd, Gs, Gg, Rd, Gd, Uu, Rd, Gg, Rr, Ch, 3 Kh, Rp, Rd, Rd, Uu, Uu, Wwg, Wog, Wog, Wo, Wo, Wo, Wo, Wo, Wo
Wo, Wo, Wo, Wo, Wog, Wog, Wwg, Rb, Gg, Uu, Gg, Rd, Gg, Hhd, Wwg, Wwg, Wog, Gd, Gd, Gd, Chr, Gd, Gd, Rd, Gd^Vo, Gd, Gd, Gd, Gs, Uu, Gg, Gg, Uu, Rd, Gd, Ch, Gd, Gg, Wo, Dd, Wo, Wwt, Wog, Wog, Wo, Wot, Wo, Wo, Wo, Wo
Wo, Wo, Wo, Wo, Wot, Wo, Wog, Ww, Uu, Dd, Rd, Gg, Re^Vh, Wog, Gd, Wog, Wog, Gd, Wog, Gd, Gd, Gd, Rd, Gg, Gg, Rd, Gd, Gs, Gs, Uu, Rd, Rd, Rd, Uu, Wo, Wo, Wo, Wo, Wo, Wo, Wot, Wog, Wog, Wog, Wo, Wog, Wo, Wo, Wo, Wo
Wo, Wo, Wo, Wo, Wog, Wo, Wog, Wo, Wwg, Wwg, Wwg, Wwt, Ww, Wog, Wo, Gs, Gs, Wog, Chw^Do, Wwf, Wwf, Wwf, Ww, Gg, Gg, Dd, Uu, Gs, Gd, Gd, Rd, Cer^Do, Wo, Wo, Wo, Wo, Wo, Wo, Wo, Wo, Ww, Wot, Wot, Wot, Wo, Wog, Wo, Wo, Wo, Wo
Wo, Wo, Wo, Wo, Wog, Wog, Wog, Wo, Wog, Wot, Wo, Wog, Wot, Wog, Wot, Uu, Ds, Wwg, Wwf, Wwf, Cdr, Ds, Re^Vu, Wo, Wo, Wot, Uu, Gd, Rd, Rd, Dd, Wo, Wo, Wo, Dd, Wo, Dd, Uu, Gg, Wo, Wwt, Wog, Wo, Wog, Wo, Wo, Wo, Wo, Wo, Wo
Wo, Wo, Wo, Wo, Wo, Wo, Wo, Wo, Wog, Wot, Wog, Wog, Wog, Wog, Wog, Rd^Vc, Ds, Wwrg, Cdr, Cdr, Kdr, Ds, Ds, Wot, Wo, Wo, Uu, Rd, Uu, Uu, Gd, Wo, Wo, Dd, Uu, Rd, Uu, Uu, Ds, Wwt, Ww, Wog, Wog, Wog, Wot, Wog, Wo, Wo, Wo, Wo
Wo, Wo, Wo, Wo, Wo, Wo, Wo, Wo, Wo, Wo, Wo, Wo, Wo, Wo, Wo, Wo, Wo, Wo, Wo, Ds, Ds, Ds, Wo, Wo, Wo, Wo, Wo, Ds, Ds, Ds, Wog, Wog, Wog, Wwg, Wwg, Ds, Wot, Ds^Vdr, Wog, Wog, Wo, Wo, Wo, Wo, Wo, Wo, Wo, Wo, Wo, Wo
Wo, Wo, Wo, Wo, Wo, Wo, Wo, Wo, Wo, Wo, Wo, Wo, Wo, Wo, Wo, Wo, Wo, Wo, Wo, Wo, Wo, Wo, Wo, Wo, Wo, Wo, Wo, Wo, Wo, Wog, Wo, Wo, Wo, Wog, Wo, Wwg, Wog, Wog, Wo, Wo, Wo, Wo, Wo, Wo, Wo, Wo, Wo, Wo, Wo, Wo
Wo, Wo, Wo, Wo, Wo, Wo, Wo, Wo, Wo, Wo, Wo, Wo, Wo, Wo, Wo, Wo, Wo, Wo, Wo, Wo, Wo, Wo, Wo, Wo, Wo, Wo, Wo, Wo, Wo, Wo, Wo, Wo, Wo, Wo, Wo, Wo, Wo, Wo, Wo, Wo, Wo, Wo, Wo, Wo, Wo, Wo, Wo, Wo, Wo, Wo
