Wo, Wo, Wo, Wo, Wo, Wo, Wo, Wo, Wo, Wo, Wo, Wo, Wo, Wo, Wo, Wo, Wo, Wo, Wo, Wo, Wo, Wo, Wo, Wo, Wo, Wo, Wo, Wo, Wo, Wo, Wo, Wo
Wo, Wo, Wo, Wo, Wo, Wo, Wo, Wo, Wo, Wo, Wo, Wo, Wo, Wo, Wo, Wo, Wo, Wo, Wo, Wo, Wo, Wo, Wo, Wo, Wo, Wo, Wo, Wo, Wo, Wo, Wo, Wo
Wo, Wo, Wo, Wo, Wo, Wo, Wo, Wo, Wo, Wo, Wo, Wo, Wo, Wo, Wo, Wo, Ww, Ww, Ww, Ww^Vm, Ww, Ww, Ww, Wo, Wo, Wo, Wo, Wo, Wo, Wo, Wo, Wo
Wo, Wo, Wo, Wo, Wo, Wo, Wo, Wo, Wo, Wo, Wo, Wo, Wo, Wo, Wo, Ww, Ww, Ww, Ww, Ww, Ww, Ww, Wo, Wo, Wo, Wo, Wo, Wo, Wo, Wo, Wo, Wo
Wo, Wo, Wo, Wo, Wo, Wo, Wo, Wo, Wo, Wo, Wo, Wo, Ww, Ww, Ww, Dd, Gs, Gs, Ch, Ch, Ch, Ww, Wo, Wo, Wo, Wo, Wo, Wo, Wo, Wo, Wo, Wo
Wo, Wo, Wo, Wo, Wo, Wo, Ww, Ww, Ww, Ww, Ww, Ww, Ww, Ww, Gg^Vh, Gs, Gs, Gs, Ch, 2 Kh, Ch, Wo, Wo, Wo, Wo, Wo, Wo, Wo, Wo, Wo, Wo, Wo
Wo, Wo, Wo, Wo, Wo, Ww, Ww, Ww^Vm, Ww, Dd, Dd, Dd, Dd, Dd, Dd, Gs^Ft, Dd, Ch, Ch, Ch, Re, Ww, Ww, Ww, Ww, Ww, Ww, Wo, Wo, Wo, Wo, Wo
Wo, Wo, Wo, Wo, Ww, Wo, Ww, Dd, Gs^Ft, Dd, Dd, Dd, Dd, Dd, Dd, Dd, Hd, Hd, Hd, Hd, Re, Gg^Vh, Ww, Ww^Vm, Ww, Ww, Ww, Ww, Wo, Wo, Wo, Wo
Wo, Wo, Wo, Wo, Ww, Ww, Ww, Gs, Gs, Gs, Gs^Ft, Hd, Hd, Hd, Hd, Hd, Hd, Hd, Hd, Hd, Re, Gs, Gs, Gs, Gs, Gs^Ft, Dd, Ww, Ww, Wo, Wo, Wo
Wo, Wo, Ww, Wo, Ww, Dd, Gs, Gs, Gs, Hd, Hd, Hd, Hd, Hd, Hd, Hd, Hd, Hd, Hd, Hd, Rd, Gs^Ft, Gs, Gs^Ft, Dd, Gs^Ft, Gs^Ft, Dd, Ww, Ww, Wo, Wo
Wo, Wo, Ww, Ww, Dd, Gs^Ft, Gg^Vh, Hd, Mdd, Mdd, Mdd, Mdd, Hd, Hd, Hd, Hd, Rd, Rd, Rd, Rd, Hd, Hd, Hd, Hd, Dd, Gs^Ft, Gs, Dd, Ww, Ww, Wo, Wo
Wo, Wo, Ww, Ww, Dd, Gs, Hd, Mdd, Mdd, Mdd, Mdd, Mdd, Mdd, Hd, Rd, Rd, Hd, Hd, Hd, Hd, Hd, Mdd, Mdd, Hd, Hd, Gs, Gs, Gs, Ww, Ww, Wo, Wo
Wo, Wo, Ww, Dd^Vda, Dd, Hd, Mdd, Mdd, Mdd, Mdd, Mdd, Mdd, Mdd, Rd, Dd^Vdt, Dd, Dd, Hd, Hd, Hd, Mdd, Mdd, Mdd, Mdd, Hd, Gs, Gs, Dd, Ww, Ww, Wo, Wo
Wo, Wo, Ww, Dd, Dd, Gs, Mdd, Mdd, Mdd, Mdd, Mdd, Hd, Hd, Rd, Dd, Dd, Gs^Ft, Hd, Hd, Mdd, Mdd, Mdd, Mdd, Mdd, Hd, Gs, Gs, Gs, Ww, Ww, Wo, Wo
Wo, Wo, Ww, Dd, Dd, Gs^Ft, Hd, Mdd, Mdd, Mdd, Hd, Hd, Dd, Rd, Dd, Dd, Dd^Vda, Hd, Hd, Mdd, Mdd, Mdd, Mdd, Mdd, Hd, Gs, Gs, Gg^Vh, Ww, Wo, Wo, Wo
Wo, Wo, Ww, Ww, Dd, Dd, Gs, Gs, Hd, Gs, Dd, Dd, Rd, Rd, Dd, Dd, Dd, Dd, Hd, Mdd, Mdd, Mdd, Mdd, Mdd, Hd, Gs, Gs, Ww, Ww, Wo, Wo, Wo
Wo, Wo, Wo, Ww, Ww, Dd, Gs^Ft, Gs, Gs, Gs, Gs, Dd, Rd, Dd, Dd, Dd, Dd, Hd, Mdd, Mdd, Mdd, Mdd, Mdd, Mdd, Hd, Gs, Gs, Ww, Ww, Wo, Wo, Wo
Wo, Wo, Wo, Wo, Ww, Ww, Ww, Dd, Dd, Dd, Dd, Dd, Rd, Dd, Dd, Dd, Dd, Hd, Mdd, Mdd, Mdd, Mdd, Mdd, Mdd, Mdd, Gs, Gs, Ww, Ww, Wo, Wo, Wo
Wo, Wo, Wo, Wo, Wo, Ww, Ww, Dd, Gs, Dd, Dd, Dd, Rd, Dd, Dd, Dd, Gs^Ft, Mdd, Mdd, Mdd, Mdd, Mdd, Mdd, Mdd, Mdd, Gs, Gs^Ft, Ww, Ww, Wo, Wo, Wo
Wo, Wo, Wo, Wo, Wo, Ww, Ww, Gs, Gs, Gs, Gs, Dd, Rd, Dd^Vda, Dd, Dd, Hd, Mdd, Mdd, Mdd, Mdd, Mdd, Mdd, Mdd, Hd, Gs, Gs^Ft, Ww, Wo, Wo, Wo, Wo
Wo, Wo, Wo, Wo, Wo, Ww, Gg^Vh, Gs, Hd, Gs, Gs, Gs^Ft, Rd, Dd, Dd, Gs^Ft, Gs^Ft, Hd, Mdd, Mdd, Mdd, Ww, Ww, Ww, Ww, Gs, Gg^Vh, Ww, Wo, Wo, Wo, Wo
Wo, Wo, Wo, Wo, Wo, Ww, Gs^Ft, Gs, Hd, Mdd, Hd, Ch, Ch, Ch, Gs^Ft, Gs, Hd, Mdd, Mdd, Mdd, Ww, Ww, Ww, Ww, Ww, Gs^Ft, Ww, Wo, Wo, Wo, Wo, Wo
Wo, Wo, Wo, Wo, Wo, Ww, Dd, Gs, Hd, Mdd, Mdd, Ch, 1 Kh, Ch, Gs, Gs, Hd, Hd, Mdd, Mdd, Ww, Ww^Vm, Ww, Ww, Dd, Dd, Ww, Wo, Wo, Wo, Wo, Wo
Wo, Wo, Wo, Wo, Wo, Ww, Dd, Dd, Hd, Hd, Ch, Ch, Ch, Gs, Gs, Gs, Hd, Mdd, Mdd, Mdd, Mdd, Ww, Ww, Ww, Dd, Dd, Ww, Wo, Wo, Wo, Wo, Wo
Wo, Wo, Wo, Wo, Wo, Ww, Dd, Dd, Dd, Hd, Hd, Hd, Gs, Gs, Gs, Gs, Gs, Hd, Hd, Hd, Mdd, Ww, Ww, Ww, Ww, Ww, Ww, Wo, Wo, Wo, Wo, Wo
Wo, Wo, Wo, Wo, Wo, Ww, Dd^Vda, Dd, Dd, Gs^Ft, Gs, Gs, Gs, Gs, Gs, Gs, Gs, Gs^Ft, Dd, Dd, Dd, Ww, Ww, Dd, Ww, Ww, Wo, Wo, Wo, Wo, Wo, Wo
Wo, Wo, Wo, Wo, Wo, Ww, Ww, Dd, Dd, Gs^Ft, Gs^Ft, Gs, Gs, Gs, Gs, Gs, Dd, Dd, Dd, Gs, Dd, Ww, Ww, Ww^Vm, Ww, Wo, Wo, Wo, Wo, Wo, Wo, Wo
Wo, Wo, Wo, Wo, Wo, Ww, Ww, Dd, Dd, Gs^Ft, Gs, Gs, Gg^Vh, Gs, Gs, Gs^Ft, Dd, Dd, Dd^Vda, Dd, Ww, Ww, Ww, Wo, Wo, Wo, Wo, Wo, Wo, Wo, Wo, Wo
Wo, Wo, Wo, Wo, Wo, Ww, Ww, Ww, Ww, Ww, Ww, Ww, Dd, Ww, Ww, Ww, Ww, Ww, Ww, Ww, Wo, Wo, Wo, Wo, Wo, Wo, Wo, Wo, Wo, Wo, Wo, Wo
Wo, Wo, Wo, Wo, Wo, Wo, Ww, Ww, Ww, Ww, Ww, Ww, Ww, Ww, Ww, Wo, Wo, Wo, Wo, Wo, Wo, Wo, Wo, Wo, Wo, Wo, Wo, Wo, Wo, Wo, Wo, Wo
Wo, Wo, Wo, Wo, Wo, Wo, Wo, Ww, Ww, Ww, Ww, Ww, Ww, Ww, Wo, Wo, Wo, Wo, Wo, Wo, Wo, Wo, Wo, Wo, Wo, Wo, Wo, Wo, Wo, Wo, Wo, Wo
Wo, Wo, Wo, Wo, Wo, Wo, Wo, Wo, Wo, Wo, Wo, Wo, Wo, Wo, Wo, Wo, Wo, Wo, Wo, Wo, Wo, Wo, Wo, Wo, Wo, Wo, Wo, Wo, Wo, Wo, Wo, Wo
